fc_id,sku_id,on_hand_qty,committed_qty,available_qty,reorder_point,max_stock_level,last_updated
FC_CA01,SKU001249,624,193,431,112,1120,2025-07-25
FC_CA01,SKU001152,513,151,362,84,840,2025-07-23
FC_CA01,SKU001412,560,180,380,84,840,2025-07-22
FC_CA01,SKU000411,790,248,542,140,1400,2025-07-26
FC_CA01,SKU001534,1567,507,1060,210,2100,2025-07-23
FC_CA01,SKU001677,244,67,177,56,560,2025-07-26
FC_CA01,SKU001919,785,251,534,140,1400,2025-07-22
FC_CA01,SKU001376,640,203,437,112,1120,2025-07-25
FC_CA01,SKU001059,1592,515,1077,210,2100,2025-07-24
FC_CA01,SKU000963,857,296,561,140,1400,2025-07-27
FC_CA01,SKU000132,254,53,201,56,560,2025-07-23
FC_CA01,SKU001294,579,178,401,112,1120,2025-07-26
FC_CA01,SKU001590,248,81,167,56,560,2025-07-23
FC_CA01,SKU001513,1638,471,1167,210,2100,2025-07-27
FC_CA01,SKU000407,589,167,422,112,1120,2025-07-22
FC_CA01,SKU000315,629,157,472,112,1120,2025-07-23
FC_CA01,SKU001256,245,71,174,56,560,2025-07-24
FC_CA01,SKU001659,545,165,380,84,840,2025-07-22
FC_CA01,SKU001511,246,81,165,56,560,2025-07-23
FC_CA01,SKU000797,1568,492,1076,210,2100,2025-07-25
FC_CA01,SKU000098,1609,468,1141,210,2100,2025-07-21
FC_CA01,SKU000467,246,69,177,56,560,2025-07-23
FC_CA01,SKU000447,1579,482,1097,210,2100,2025-07-23
FC_CA01,SKU000316,796,239,557,140,1400,2025-07-24
FC_CA01,SKU000185,852,225,627,140,1400,2025-07-25
FC_CA01,SKU000738,244,76,168,56,560,2025-07-21
FC_CA01,SKU000076,852,268,584,140,1400,2025-07-26
FC_CA01,SKU001530,512,181,331,84,840,2025-07-24
FC_CA01,SKU000048,262,99,163,56,560,2025-07-26
FC_CA01,SKU001696,251,83,168,56,560,2025-07-27
FC_CA01,SKU001695,645,149,496,112,1120,2025-07-26
FC_CA01,SKU001960,632,195,437,112,1120,2025-07-24
FC_CA01,SKU001948,568,178,390,112,1120,2025-07-26
FC_CA01,SKU000684,871,264,607,140,1400,2025-07-24
FC_CA01,SKU001965,1613,449,1164,210,2100,2025-07-24
FC_CA01,SKU000639,546,148,398,84,840,2025-07-26
FC_CA01,SKU000622,1598,485,1113,210,2100,2025-07-24
FC_CA01,SKU001595,1645,486,1159,210,2100,2025-07-24
FC_CA01,SKU001223,617,178,439,112,1120,2025-07-24
FC_CA01,SKU000400,1553,499,1054,210,2100,2025-07-27
FC_CA01,SKU000807,232,68,164,56,560,2025-07-22
FC_CA01,SKU001169,586,186,400,112,1120,2025-07-22
FC_CA01,SKU000574,1592,476,1116,210,2100,2025-07-27
FC_CA01,SKU000143,636,206,430,112,1120,2025-07-26
FC_CA01,SKU001896,570,165,405,84,840,2025-07-23
FC_CA01,SKU000962,530,139,391,84,840,2025-07-27
FC_CA01,SKU001352,797,227,570,140,1400,2025-07-23
FC_CA01,SKU000591,229,73,156,56,560,2025-07-22
FC_CA01,SKU000175,624,197,427,112,1120,2025-07-22
FC_CA01,SKU000262,241,68,173,56,560,2025-07-25
FC_CA01,SKU000610,235,63,172,56,560,2025-07-24
FC_CA01,SKU000598,535,167,368,84,840,2025-07-27
FC_CA01,SKU001358,1562,485,1077,210,2100,2025-07-27
FC_CA01,SKU000599,242,77,165,56,560,2025-07-26
FC_CA01,SKU001325,589,169,420,112,1120,2025-07-26
FC_CA01,SKU001953,1562,454,1108,210,2100,2025-07-24
FC_CA01,SKU000077,1540,463,1077,210,2100,2025-07-21
FC_CA01,SKU001669,518,141,377,84,840,2025-07-25
FC_CA01,SKU000891,551,161,390,84,840,2025-07-21
FC_CA01,SKU001296,659,185,474,112,1120,2025-07-23
FC_CA01,SKU000109,597,151,446,112,1120,2025-07-21
FC_CA01,SKU000894,613,190,423,112,1120,2025-07-25
FC_CA01,SKU001749,231,63,168,56,560,2025-07-21
FC_CA01,SKU000596,558,152,406,84,840,2025-07-23
FC_CA01,SKU001304,258,70,188,56,560,2025-07-24
FC_CA01,SKU001281,1524,454,1070,210,2100,2025-07-25
FC_CA01,SKU000628,247,74,173,56,560,2025-07-25
FC_CA01,SKU001285,252,80,172,56,560,2025-07-21
FC_CA01,SKU000418,516,177,339,84,840,2025-07-27
FC_CA01,SKU001382,234,81,153,56,560,2025-07-26
FC_CA01,SKU000311,253,92,161,56,560,2025-07-24
FC_CA01,SKU001913,565,178,387,84,840,2025-07-26
FC_CA01,SKU001447,872,274,598,140,1400,2025-07-27
FC_CA01,SKU001848,842,242,600,140,1400,2025-07-26
FC_CA01,SKU000478,625,212,413,112,1120,2025-07-23
FC_CA01,SKU000465,810,255,555,140,1400,2025-07-27
FC_CA01,SKU001672,539,152,387,84,840,2025-07-26
FC_CA01,SKU001904,812,256,556,140,1400,2025-07-24
FC_CA01,SKU001091,1582,462,1120,210,2100,2025-07-24
FC_CA01,SKU001494,650,205,445,112,1120,2025-07-26
FC_CA01,SKU000788,1561,447,1114,210,2100,2025-07-26
FC_CA01,SKU001779,1609,499,1110,210,2100,2025-07-21
FC_CA01,SKU000813,530,174,356,84,840,2025-07-23
FC_CA01,SKU000540,860,269,591,140,1400,2025-07-24
FC_CA01,SKU000700,252,69,183,56,560,2025-07-22
FC_CA01,SKU000001,549,167,382,84,840,2025-07-23
FC_CA01,SKU000960,528,157,371,84,840,2025-07-25
FC_CA01,SKU000169,639,192,447,112,1120,2025-07-23
FC_CA01,SKU001106,1621,437,1184,210,2100,2025-07-27
FC_CA01,SKU001970,821,228,593,140,1400,2025-07-24
FC_CA01,SKU000240,260,96,164,56,560,2025-07-24
FC_CA01,SKU001586,1556,502,1054,210,2100,2025-07-22
FC_CA01,SKU000104,607,167,440,112,1120,2025-07-21
FC_CA01,SKU000450,622,159,463,112,1120,2025-07-26
FC_CA01,SKU000751,567,166,401,112,1120,2025-07-25
FC_CA01,SKU001172,883,247,636,140,1400,2025-07-26
FC_CA01,SKU001753,231,58,173,56,560,2025-07-22
FC_CA01,SKU001137,640,200,440,112,1120,2025-07-26
FC_CA01,SKU001946,885,265,620,140,1400,2025-07-26
FC_CA01,SKU001145,531,160,371,84,840,2025-07-25
FC_CA01,SKU000883,803,232,571,140,1400,2025-07-25
FC_CA01,SKU001028,837,256,581,140,1400,2025-07-26
FC_CA01,SKU001112,261,84,177,56,560,2025-07-22
FC_CA01,SKU000672,611,166,445,112,1120,2025-07-21
FC_CA01,SKU000195,806,242,564,140,1400,2025-07-26
FC_CA01,SKU000060,510,137,373,84,840,2025-07-27
FC_CA01,SKU000611,867,259,608,140,1400,2025-07-21
FC_CA01,SKU001410,251,83,168,56,560,2025-07-23
FC_CA01,SKU000034,614,196,418,112,1120,2025-07-23
FC_CA01,SKU001694,271,68,203,56,560,2025-07-23
FC_CA01,SKU001126,513,140,373,84,840,2025-07-25
FC_CA01,SKU000260,839,259,580,140,1400,2025-07-26
FC_CA01,SKU001769,234,55,179,56,560,2025-07-26
FC_CA01,SKU000123,764,240,524,140,1400,2025-07-26
FC_CA01,SKU000575,838,256,582,140,1400,2025-07-24
FC_CA01,SKU000218,1579,453,1126,210,2100,2025-07-24
FC_CA01,SKU000029,1635,511,1124,210,2100,2025-07-22
FC_CA01,SKU000701,1595,459,1136,210,2100,2025-07-21
FC_CA01,SKU000836,842,261,581,140,1400,2025-07-27
FC_CA01,SKU000515,1600,474,1126,210,2100,2025-07-24
FC_CA01,SKU000113,547,165,382,84,840,2025-07-23
FC_CA01,SKU001664,249,75,174,56,560,2025-07-26
FC_CA01,SKU000215,846,264,582,140,1400,2025-07-22
FC_CA01,SKU000437,1569,494,1075,210,2100,2025-07-22
FC_CA01,SKU000778,535,141,394,84,840,2025-07-27
FC_CA01,SKU001235,1545,518,1027,210,2100,2025-07-23
FC_CA01,SKU000094,1510,451,1059,210,2100,2025-07-21
FC_CA01,SKU001557,639,176,463,112,1120,2025-07-21
FC_CA01,SKU000618,548,155,393,84,840,2025-07-23
FC_CA01,SKU001478,820,223,597,140,1400,2025-07-24
FC_CA01,SKU000766,243,66,177,56,560,2025-07-21
FC_CA01,SKU001974,517,165,352,84,840,2025-07-23
FC_CA01,SKU000497,1583,482,1101,210,2100,2025-07-25
FC_CA01,SKU001954,1546,495,1051,210,2100,2025-07-27
FC_CA01,SKU001177,555,165,390,84,840,2025-07-23
FC_CA01,SKU001998,872,242,630,140,1400,2025-07-26
FC_CA01,SKU001942,242,72,170,56,560,2025-07-22
FC_CA01,SKU001959,831,243,588,140,1400,2025-07-26
FC_CA01,SKU001178,1571,490,1081,210,2100,2025-07-23
FC_CA01,SKU001915,1571,469,1102,210,2100,2025-07-22
FC_CA01,SKU001046,633,165,468,112,1120,2025-07-21
FC_CA01,SKU001866,1515,464,1051,210,2100,2025-07-23
FC_CA01,SKU000666,785,237,548,140,1400,2025-07-21
FC_CA01,SKU000664,856,250,606,140,1400,2025-07-21
FC_CA01,SKU000479,803,267,536,140,1400,2025-07-26
FC_CA01,SKU000425,854,256,598,140,1400,2025-07-25
FC_CA01,SKU000710,237,80,157,56,560,2025-07-25
FC_CA01,SKU001944,1605,532,1073,210,2100,2025-07-24
FC_CA01,SKU000259,1555,438,1117,210,2100,2025-07-26
FC_CA01,SKU000190,1621,456,1165,210,2100,2025-07-25
FC_CA01,SKU001872,278,78,200,56,560,2025-07-22
FC_CA01,SKU000934,562,174,388,84,840,2025-07-27
FC_CA01,SKU001055,591,168,423,112,1120,2025-07-24
FC_CA01,SKU000338,605,180,425,112,1120,2025-07-26
FC_CA01,SKU000876,894,251,643,140,1400,2025-07-27
FC_CA01,SKU001472,813,246,567,140,1400,2025-07-27
FC_CA01,SKU000135,551,145,406,84,840,2025-07-27
FC_CA01,SKU001180,823,236,587,140,1400,2025-07-26
FC_CA01,SKU000251,262,80,182,56,560,2025-07-27
FC_CA01,SKU000387,1592,456,1136,210,2100,2025-07-27
FC_CA01,SKU001909,1610,468,1142,210,2100,2025-07-27
FC_CA01,SKU000177,649,197,452,112,1120,2025-07-24
FC_CA01,SKU000252,634,217,417,112,1120,2025-07-25
FC_CA01,SKU001001,1546,460,1086,210,2100,2025-07-27
FC_CA01,SKU001992,262,77,185,56,560,2025-07-26
FC_CA01,SKU001560,1541,518,1023,210,2100,2025-07-25
FC_CA01,SKU000804,266,66,200,56,560,2025-07-26
FC_CA01,SKU001766,573,177,396,84,840,2025-07-26
FC_CA01,SKU001227,1587,468,1119,210,2100,2025-07-22
FC_CA01,SKU001795,834,235,599,140,1400,2025-07-22
FC_CA01,SKU000755,565,166,399,84,840,2025-07-24
FC_CA01,SKU000740,549,168,381,84,840,2025-07-22
FC_CA01,SKU001453,515,175,340,84,840,2025-07-26
FC_CA01,SKU001890,629,201,428,112,1120,2025-07-24
FC_CA01,SKU001439,1653,500,1153,210,2100,2025-07-26
FC_CA01,SKU000386,531,145,386,84,840,2025-07-21
FC_CA01,SKU001003,1574,481,1093,210,2100,2025-07-21
FC_CA01,SKU000149,579,168,411,112,1120,2025-07-25
FC_CA01,SKU000339,854,244,610,140,1400,2025-07-23
FC_CA01,SKU001291,1559,488,1071,210,2100,2025-07-23
FC_CA01,SKU000466,786,217,569,140,1400,2025-07-27
FC_CA01,SKU001849,265,81,184,56,560,2025-07-25
FC_CA01,SKU000284,856,261,595,140,1400,2025-07-22
FC_CA01,SKU000674,255,68,187,56,560,2025-07-21
FC_CA01,SKU001640,646,194,452,112,1120,2025-07-27
FC_CA01,SKU001022,1556,475,1081,210,2100,2025-07-23
FC_CA01,SKU000899,622,193,429,84,840,2025-07-22
FC_CA01,SKU000361,600,156,444,112,1120,2025-07-26
FC_CA01,SKU000081,542,159,383,84,840,2025-07-27
FC_CA01,SKU001724,1618,489,1129,210,2100,2025-07-25
FC_CA01,SKU000780,612,201,411,112,1120,2025-07-25
FC_CA01,SKU000631,595,170,425,112,1120,2025-07-27
FC_CA01,SKU001208,846,272,574,140,1400,2025-07-26
FC_CA01,SKU000595,1572,418,1154,210,2100,2025-07-27
FC_CA01,SKU000676,1613,488,1125,210,2100,2025-07-27
FC_CA01,SKU001107,595,186,409,112,1120,2025-07-27
FC_CA01,SKU001431,544,172,372,84,840,2025-07-24
FC_CA01,SKU001314,245,69,176,56,560,2025-07-22
FC_CA01,SKU000758,535,156,379,84,840,2025-07-21
FC_CA01,SKU000480,1572,461,1111,210,2100,2025-07-21
FC_CA01,SKU001295,1570,464,1106,210,2100,2025-07-23
FC_CA01,SKU001562,624,163,461,112,1120,2025-07-23
FC_CA01,SKU001471,810,247,563,140,1400,2025-07-25
FC_CA01,SKU001755,1586,474,1112,210,2100,2025-07-25
FC_CA01,SKU001675,823,241,582,140,1400,2025-07-21
FC_CA01,SKU000647,235,78,157,56,560,2025-07-23
FC_CA01,SKU001408,1550,449,1101,210,2100,2025-07-21
FC_CA01,SKU000827,568,173,395,84,840,2025-07-24
FC_CA01,SKU000865,1589,499,1090,210,2100,2025-07-22
FC_CA01,SKU001213,1657,487,1170,210,2100,2025-07-24
FC_CA01,SKU000709,536,156,380,84,840,2025-07-22
FC_CA01,SKU001167,617,201,416,112,1120,2025-07-22
FC_CA01,SKU001420,538,150,388,84,840,2025-07-24
FC_CA01,SKU001626,1642,481,1161,210,2100,2025-07-23
FC_CA01,SKU001985,563,185,378,84,840,2025-07-21
FC_CA01,SKU001311,828,245,583,140,1400,2025-07-26
FC_CA01,SKU002000,488,165,323,84,840,2025-07-25
FC_CA01,SKU000694,256,71,185,56,560,2025-07-25
FC_CA01,SKU000768,877,257,620,140,1400,2025-07-22
FC_CA01,SKU000161,565,186,379,84,840,2025-07-23
FC_CA01,SKU001187,260,78,182,56,560,2025-07-23
FC_CA01,SKU000274,562,155,407,84,840,2025-07-25
FC_CA01,SKU001070,880,231,649,140,1400,2025-07-23
FC_CA01,SKU000867,542,141,401,84,840,2025-07-27
FC_CA01,SKU000167,592,177,415,112,1120,2025-07-24
FC_CA01,SKU000477,546,163,383,84,840,2025-07-25
FC_CA01,SKU001264,297,80,217,56,560,2025-07-26
FC_CA01,SKU001796,634,204,430,112,1120,2025-07-26
FC_CA01,SKU001723,895,288,607,140,1400,2025-07-21
FC_CA01,SKU001802,541,154,387,84,840,2025-07-24
FC_CA01,SKU000056,517,144,373,84,840,2025-07-27
FC_CA01,SKU001460,270,79,191,56,560,2025-07-26
FC_CA01,SKU000765,592,168,424,112,1120,2025-07-21
FC_CA01,SKU000603,571,174,397,84,840,2025-07-21
FC_CA01,SKU000163,1588,459,1129,210,2100,2025-07-27
FC_CA01,SKU001300,676,200,476,112,1120,2025-07-24
FC_CA01,SKU000020,556,192,364,84,840,2025-07-27
FC_CA01,SKU001268,241,61,180,56,560,2025-07-22
FC_CA01,SKU000287,495,141,354,84,840,2025-07-26
FC_CA01,SKU000194,600,174,426,112,1120,2025-07-21
FC_CA01,SKU001692,279,72,207,56,560,2025-07-24
FC_CA01,SKU000359,839,246,593,140,1400,2025-07-24
FC_CA01,SKU000803,607,201,406,112,1120,2025-07-23
FC_CA01,SKU000416,251,78,173,56,560,2025-07-27
FC_CA01,SKU001632,546,188,358,84,840,2025-07-26
FC_CA01,SKU000270,250,78,172,56,560,2025-07-27
FC_CA01,SKU001838,1542,468,1074,210,2100,2025-07-26
FC_CA01,SKU000131,266,85,181,56,560,2025-07-25
FC_CA01,SKU000212,749,195,554,140,1400,2025-07-21
FC_CA01,SKU001341,831,262,569,140,1400,2025-07-22
FC_CA01,SKU001847,563,181,382,84,840,2025-07-27
FC_CA01,SKU000695,610,173,437,112,1120,2025-07-26
FC_CA01,SKU000687,533,144,389,84,840,2025-07-25
FC_CA01,SKU001964,865,259,606,140,1400,2025-07-26
FC_CA01,SKU000276,539,152,387,84,840,2025-07-25
FC_CA01,SKU000869,480,143,337,84,840,2025-07-22
FC_CA01,SKU000289,547,156,391,84,840,2025-07-22
FC_CA01,SKU001720,1637,502,1135,210,2100,2025-07-23
FC_CA01,SKU001958,600,182,418,112,1120,2025-07-25
FC_CA01,SKU000192,1577,488,1089,210,2100,2025-07-24
FC_CA01,SKU000022,845,253,592,140,1400,2025-07-24
FC_CA01,SKU001895,645,187,458,112,1120,2025-07-25
FC_CA01,SKU000524,856,255,601,140,1400,2025-07-21
FC_CA01,SKU000248,1687,505,1182,210,2100,2025-07-24
FC_CA01,SKU000499,587,177,410,112,1120,2025-07-23
FC_CA01,SKU001424,1521,493,1028,210,2100,2025-07-22
FC_CA01,SKU001014,266,71,195,56,560,2025-07-25
FC_CA01,SKU001458,281,88,193,56,560,2025-07-23
FC_CA01,SKU001615,1550,425,1125,210,2100,2025-07-27
FC_CA01,SKU000171,1623,520,1103,210,2100,2025-07-23
FC_CA01,SKU001338,1569,503,1066,210,2100,2025-07-24
FC_CA01,SKU001681,845,242,603,140,1400,2025-07-27
FC_CA01,SKU000115,1587,424,1163,210,2100,2025-07-27
FC_CA01,SKU001386,539,148,391,84,840,2025-07-25
FC_CA01,SKU001030,633,201,432,112,1120,2025-07-23
FC_CA01,SKU000211,788,228,560,140,1400,2025-07-21
FC_CA01,SKU000896,839,278,561,140,1400,2025-07-23
FC_CA01,SKU000150,864,248,616,140,1400,2025-07-21
FC_CA01,SKU001645,805,226,579,140,1400,2025-07-21
FC_CA01,SKU000554,606,174,432,112,1120,2025-07-27
FC_CA01,SKU001063,825,256,569,140,1400,2025-07-25
FC_CA01,SKU001765,902,264,638,140,1400,2025-07-21
FC_CA01,SKU001514,258,75,183,56,560,2025-07-24
FC_CA01,SKU001219,606,162,444,112,1120,2025-07-21
FC_CA01,SKU000327,809,244,565,140,1400,2025-07-21
FC_CA01,SKU000520,595,190,405,84,840,2025-07-23
FC_CA01,SKU001054,1530,450,1080,210,2100,2025-07-24
FC_CA01,SKU000155,1600,504,1096,210,2100,2025-07-22
FC_CA01,SKU001147,599,186,413,112,1120,2025-07-26
FC_CA01,SKU000918,586,190,396,112,1120,2025-07-21
FC_CA01,SKU000468,827,244,583,140,1400,2025-07-23
FC_CA01,SKU000873,653,188,465,112,1120,2025-07-25
FC_CA01,SKU000351,563,198,365,84,840,2025-07-24
FC_CA01,SKU001421,595,173,422,112,1120,2025-07-23
FC_CA01,SKU000268,265,75,190,56,560,2025-07-23
FC_CA01,SKU001438,837,236,601,140,1400,2025-07-26
FC_CA01,SKU001856,256,76,180,56,560,2025-07-24
FC_CA01,SKU000568,255,75,180,56,560,2025-07-23
FC_CA01,SKU000267,605,181,424,112,1120,2025-07-21
FC_CA01,SKU001206,533,149,384,84,840,2025-07-23
FC_CA01,SKU001663,592,177,415,84,840,2025-07-24
FC_CA01,SKU000531,606,203,403,112,1120,2025-07-22
FC_CA01,SKU000951,251,91,160,56,560,2025-07-24
FC_CA01,SKU000093,852,251,601,140,1400,2025-07-21
FC_CA01,SKU000097,235,64,171,56,560,2025-07-24
FC_CA01,SKU000588,862,259,603,140,1400,2025-07-26
FC_CA01,SKU000832,534,191,343,84,840,2025-07-22
FC_CA01,SKU000401,850,272,578,140,1400,2025-07-27
FC_CA01,SKU000049,834,268,566,140,1400,2025-07-27
FC_CA01,SKU000776,819,262,557,140,1400,2025-07-26
FC_CA01,SKU000074,1626,463,1163,210,2100,2025-07-25
FC_CA01,SKU000222,836,269,567,140,1400,2025-07-22
FC_CA01,SKU001676,1575,459,1116,210,2100,2025-07-21
FC_CA01,SKU001049,575,189,386,84,840,2025-07-26
FC_CA01,SKU001216,656,224,432,112,1120,2025-07-26
FC_CA01,SKU000383,1491,454,1037,210,2100,2025-07-24
FC_CA01,SKU001456,649,193,456,112,1120,2025-07-22
FC_CA01,SKU000476,579,174,405,84,840,2025-07-23
FC_CA01,SKU000811,548,174,374,84,840,2025-07-22
FC_CA01,SKU001465,872,263,609,140,1400,2025-07-21
FC_CA01,SKU000090,1569,461,1108,210,2100,2025-07-22
FC_CA01,SKU001880,545,156,389,84,840,2025-07-27
FC_CA01,SKU000550,858,251,607,140,1400,2025-07-22
FC_CA01,SKU001498,603,182,421,112,1120,2025-07-27
FC_CA01,SKU000582,813,250,563,140,1400,2025-07-24
FC_CA01,SKU001713,592,197,395,112,1120,2025-07-27
FC_CA01,SKU001551,802,247,555,140,1400,2025-07-22
FC_CA01,SKU000739,863,290,573,140,1400,2025-07-21
FC_CA01,SKU001832,595,186,409,112,1120,2025-07-25
FC_CA01,SKU000692,627,197,430,112,1120,2025-07-22
FC_CA01,SKU000451,236,62,174,56,560,2025-07-26
FC_CA01,SKU001536,261,84,177,56,560,2025-07-25
FC_CA01,SKU001430,1548,505,1043,210,2100,2025-07-21
FC_CA01,SKU001792,833,229,604,140,1400,2025-07-26
FC_CA01,SKU000441,269,75,194,56,560,2025-07-27
FC_CA01,SKU000528,899,277,622,140,1400,2025-07-26
FC_CA01,SKU000061,629,206,423,112,1120,2025-07-23
FC_CA01,SKU000367,607,163,444,112,1120,2025-07-21
FC_CA01,SKU000756,553,154,399,84,840,2025-07-23
FC_CA01,SKU000279,1546,451,1095,210,2100,2025-07-22
FC_CA01,SKU000332,840,266,574,140,1400,2025-07-24
FC_CA01,SKU000423,1538,452,1086,210,2100,2025-07-21
FC_CA01,SKU001704,595,176,419,112,1120,2025-07-24
FC_CA01,SKU001641,534,146,388,84,840,2025-07-25
FC_CA01,SKU000037,692,207,485,112,1120,2025-07-21
FC_CA01,SKU001318,515,135,380,84,840,2025-07-26
FC_CA01,SKU000138,625,203,422,112,1120,2025-07-24
FC_CA01,SKU001273,520,156,364,84,840,2025-07-22
FC_CA01,SKU000736,578,178,400,84,840,2025-07-25
FC_CA01,SKU000384,261,79,182,56,560,2025-07-25
FC_CA01,SKU000573,1638,476,1162,210,2100,2025-07-23
FC_CA01,SKU001613,616,178,438,112,1120,2025-07-26
FC_CA01,SKU001163,608,184,424,112,1120,2025-07-22
FC_CA01,SKU000058,625,178,447,112,1120,2025-07-24
FC_CA01,SKU000309,534,137,397,84,840,2025-07-25
FC_CA01,SKU001290,225,60,165,56,560,2025-07-26
FC_CA01,SKU000839,279,88,191,56,560,2025-07-21
FC_CA01,SKU000285,526,134,392,84,840,2025-07-26
FC_CA01,SKU001267,827,267,560,140,1400,2025-07-24
FC_CA01,SKU001243,504,154,350,84,840,2025-07-27
FC_CA01,SKU001930,535,151,384,84,840,2025-07-26
FC_CA01,SKU001381,628,179,449,112,1120,2025-07-27
FC_CA01,SKU001098,1587,526,1061,210,2100,2025-07-26
FC_CA01,SKU001475,237,69,168,56,560,2025-07-22
FC_CA01,SKU000112,1600,477,1123,210,2100,2025-07-23
FC_CA01,SKU001390,541,158,383,84,840,2025-07-26
FC_CA01,SKU001158,604,178,426,112,1120,2025-07-27
FC_CA01,SKU000271,629,183,446,112,1120,2025-07-25
FC_CA01,SKU001057,539,142,397,84,840,2025-07-26
FC_CA01,SKU000821,569,181,388,84,840,2025-07-26
FC_CA01,SKU001710,602,186,416,112,1120,2025-07-22
FC_CA01,SKU001737,845,254,591,140,1400,2025-07-26
FC_CA01,SKU001468,626,184,442,112,1120,2025-07-22
FC_CA01,SKU000032,556,177,379,84,840,2025-07-23
FC_CA01,SKU000877,1598,500,1098,210,2100,2025-07-21
FC_CA01,SKU000886,247,88,159,56,560,2025-07-27
FC_CA01,SKU001174,555,153,402,84,840,2025-07-27
FC_CA01,SKU000340,603,192,411,112,1120,2025-07-23
FC_CA01,SKU000656,1606,478,1128,210,2100,2025-07-22
FC_CA01,SKU001922,870,265,605,140,1400,2025-07-26
FC_CA01,SKU000312,845,240,605,140,1400,2025-07-25
FC_CA01,SKU000052,240,70,170,56,560,2025-07-26
FC_CA01,SKU001031,258,74,184,56,560,2025-07-21
FC_CA01,SKU000947,623,185,438,112,1120,2025-07-26
FC_CA01,SKU001788,252,84,168,56,560,2025-07-21
FC_CA01,SKU001328,628,196,432,112,1120,2025-07-21
FC_CA01,SKU000028,1554,454,1100,210,2100,2025-07-22
FC_CA01,SKU000487,277,69,208,56,560,2025-07-23
FC_CA01,SKU001773,272,88,184,56,560,2025-07-26
FC_CA01,SKU000439,241,69,172,56,560,2025-07-26
FC_CA01,SKU001196,874,258,616,140,1400,2025-07-22
FC_CA01,SKU001482,819,224,595,140,1400,2025-07-24
FC_CA01,SKU001625,864,258,606,140,1400,2025-07-24
FC_CA01,SKU000178,534,161,373,84,840,2025-07-25
FC_CA01,SKU001440,1649,491,1158,210,2100,2025-07-23
FC_CA01,SKU001860,236,75,161,56,560,2025-07-26
FC_CA01,SKU000080,829,205,624,140,1400,2025-07-27
FC_CA01,SKU001693,611,192,419,112,1120,2025-07-24
FC_CA01,SKU000919,817,265,552,140,1400,2025-07-23
FC_CA01,SKU001140,842,276,566,140,1400,2025-07-21
FC_CA01,SKU001837,631,172,459,112,1120,2025-07-21
FC_CA01,SKU001082,233,70,163,56,560,2025-07-23
FC_CA01,SKU000474,878,287,591,140,1400,2025-07-27
FC_CA01,SKU001301,583,182,401,112,1120,2025-07-27
FC_CA01,SKU001885,638,204,434,112,1120,2025-07-27
FC_CA01,SKU001492,247,93,154,56,560,2025-07-21
FC_CA01,SKU001820,616,188,428,112,1120,2025-07-26
FC_CA01,SKU001667,623,197,426,112,1120,2025-07-24
FC_CA01,SKU000789,566,159,407,112,1120,2025-07-26
FC_CA01,SKU001074,255,76,179,56,560,2025-07-25
FC_CA01,SKU000435,1575,436,1139,210,2100,2025-07-27
FC_CA01,SKU001842,630,177,453,112,1120,2025-07-24
FC_CA01,SKU000543,854,245,609,140,1400,2025-07-22
FC_CA01,SKU001868,533,151,382,84,840,2025-07-27
FC_CA01,SKU001977,642,216,426,112,1120,2025-07-26
FC_CA01,SKU001072,1531,458,1073,210,2100,2025-07-27
FC_CA01,SKU001349,260,78,182,56,560,2025-07-24
FC_CA01,SKU000753,884,274,610,140,1400,2025-07-27
FC_CA01,SKU000457,929,280,649,140,1400,2025-07-26
FC_CA01,SKU001387,850,255,595,140,1400,2025-07-24
FC_CA01,SKU000707,263,81,182,56,560,2025-07-23
FC_CA01,SKU000159,807,240,567,140,1400,2025-07-23
FC_CA01,SKU001945,1571,494,1077,210,2100,2025-07-21
FC_CA01,SKU001414,1621,472,1149,210,2100,2025-07-23
FC_CA01,SKU001042,560,175,385,112,1120,2025-07-22
FC_CA01,SKU001373,249,74,175,56,560,2025-07-23
FC_CA01,SKU000019,1637,500,1137,210,2100,2025-07-25
FC_CA01,SKU001517,251,69,182,56,560,2025-07-27
FC_CA01,SKU001094,621,181,440,112,1120,2025-07-25
FC_CA01,SKU000124,263,70,193,56,560,2025-07-27
FC_CA01,SKU000293,619,198,421,112,1120,2025-07-26
FC_CA01,SKU001829,1531,460,1071,210,2100,2025-07-21
FC_CA01,SKU000472,246,86,160,56,560,2025-07-23
FC_CA01,SKU000096,1579,509,1070,210,2100,2025-07-26
FC_CA01,SKU000930,1573,514,1059,210,2100,2025-07-25
FC_CA01,SKU000337,259,64,195,56,560,2025-07-25
FC_CA01,SKU000559,592,171,421,84,840,2025-07-26
FC_CA01,SKU001068,565,166,399,84,840,2025-07-27
FC_CA01,SKU000956,828,232,596,140,1400,2025-07-25
FC_CA01,SKU000660,642,187,455,112,1120,2025-07-24
FC_CA01,SKU001479,662,170,492,112,1120,2025-07-24
FC_CA01,SKU001332,231,47,184,56,560,2025-07-26
FC_CA01,SKU001400,656,195,461,112,1120,2025-07-25
FC_CA01,SKU000014,854,246,608,140,1400,2025-07-24
FC_CA01,SKU001555,829,236,593,140,1400,2025-07-23
FC_CA01,SKU000862,546,142,404,84,840,2025-07-21
FC_CA01,SKU000430,827,270,557,140,1400,2025-07-22
FC_CA01,SKU001449,1554,426,1128,210,2100,2025-07-24
FC_CA01,SKU001879,816,223,593,140,1400,2025-07-26
FC_CA01,SKU000948,1552,416,1136,210,2100,2025-07-24
FC_CA01,SKU000493,254,76,178,56,560,2025-07-23
FC_CA01,SKU000608,1641,485,1156,210,2100,2025-07-21
FC_CA01,SKU001130,1534,476,1058,210,2100,2025-07-27
FC_CA01,SKU001363,246,70,176,56,560,2025-07-22
FC_CA01,SKU001600,861,291,570,140,1400,2025-07-23
FC_CA01,SKU000026,624,186,438,112,1120,2025-07-22
FC_CA01,SKU001118,514,137,377,84,840,2025-07-22
FC_CA01,SKU000985,541,162,379,84,840,2025-07-23
FC_CA01,SKU000393,262,93,169,56,560,2025-07-25
FC_CA01,SKU001255,787,241,546,140,1400,2025-07-26
FC_CA01,SKU001043,238,84,154,56,560,2025-07-25
FC_CA01,SKU000721,618,184,434,112,1120,2025-07-21
FC_CA01,SKU000760,807,229,578,140,1400,2025-07-24
FC_CA01,SKU000226,267,75,192,56,560,2025-07-21
FC_CA01,SKU000282,597,199,398,112,1120,2025-07-22
FC_CA01,SKU000745,606,168,438,112,1120,2025-07-22
FC_CA01,SKU000845,537,164,373,84,840,2025-07-26
FC_CA01,SKU001746,817,229,588,140,1400,2025-07-25
FC_CA01,SKU001164,1543,468,1075,210,2100,2025-07-24
FC_CA01,SKU001362,546,169,377,84,840,2025-07-23
FC_CA01,SKU001925,545,172,373,84,840,2025-07-25
FC_CA01,SKU000459,784,227,557,140,1400,2025-07-21
FC_CA01,SKU001528,545,144,401,84,840,2025-07-27
FC_CA01,SKU000975,870,276,594,140,1400,2025-07-24
FC_CA01,SKU000413,627,183,444,112,1120,2025-07-24
FC_CA01,SKU001509,628,192,436,112,1120,2025-07-25
FC_CA01,SKU001131,875,288,587,140,1400,2025-07-26
FC_CA01,SKU000079,578,168,410,112,1120,2025-07-23
FC_CA01,SKU000209,550,171,379,84,840,2025-07-22
FC_CA01,SKU001725,536,171,365,84,840,2025-07-24
FC_CA01,SKU000844,842,237,605,140,1400,2025-07-27
FC_CA01,SKU000775,539,164,375,84,840,2025-07-22
FC_CA01,SKU001179,586,190,396,84,840,2025-07-26
FC_CA01,SKU001123,242,65,177,56,560,2025-07-26
FC_CA01,SKU001744,667,204,463,112,1120,2025-07-23
FC_CA01,SKU000860,887,286,601,140,1400,2025-07-22
FC_CA01,SKU001538,857,249,608,140,1400,2025-07-24
FC_CA01,SKU001685,1574,478,1096,210,2100,2025-07-26
FC_CA01,SKU001191,529,180,349,84,840,2025-07-26
FC_CA01,SKU000621,263,77,186,56,560,2025-07-26
FC_CA01,SKU001825,550,154,396,84,840,2025-07-21
FC_CA01,SKU001673,512,159,353,84,840,2025-07-23
FC_CA01,SKU000534,553,163,390,84,840,2025-07-27
FC_CA01,SKU000170,835,245,590,140,1400,2025-07-22
FC_CA01,SKU000727,1588,495,1093,210,2100,2025-07-27
FC_CA01,SKU000871,642,195,447,112,1120,2025-07-21
FC_CA01,SKU001413,792,254,538,140,1400,2025-07-26
FC_CA01,SKU000840,851,266,585,140,1400,2025-07-21
FC_CA01,SKU000436,802,235,567,140,1400,2025-07-21
FC_CA01,SKU000120,629,192,437,112,1120,2025-07-21
FC_CA01,SKU000594,1629,452,1177,210,2100,2025-07-22
FC_CA01,SKU001486,238,79,159,56,560,2025-07-24
FC_CA01,SKU001195,537,153,384,84,840,2025-07-24
FC_CA01,SKU001512,257,78,179,56,560,2025-07-27
FC_CA01,SKU001409,558,165,393,84,840,2025-07-27
FC_CA01,SKU000898,561,165,396,112,1120,2025-07-26
FC_CA01,SKU000455,536,160,376,84,840,2025-07-24
FC_CA01,SKU001483,1599,456,1143,210,2100,2025-07-22
FC_CA01,SKU000915,255,76,179,56,560,2025-07-26
FC_CA01,SKU001203,621,174,447,112,1120,2025-07-23
FC_CA01,SKU001170,849,252,597,140,1400,2025-07-25
FC_CA01,SKU001519,540,141,399,84,840,2025-07-26
FC_CA01,SKU001902,603,220,383,112,1120,2025-07-23
FC_CA01,SKU000716,639,181,458,112,1120,2025-07-23
FC_CA01,SKU001292,616,162,454,112,1120,2025-07-23
FC_CA01,SKU000039,587,195,392,112,1120,2025-07-23
FC_CA01,SKU001071,276,82,194,56,560,2025-07-27
FC_CA01,SKU000412,650,195,455,112,1120,2025-07-23
FC_CA01,SKU001080,236,73,163,56,560,2025-07-23
FC_CA01,SKU000614,660,182,478,112,1120,2025-07-27
FC_CA01,SKU000377,556,158,398,84,840,2025-07-26
FC_CA01,SKU000278,883,262,621,140,1400,2025-07-26
FC_CA01,SKU001607,228,72,156,56,560,2025-07-27
FC_CA01,SKU001084,518,157,361,84,840,2025-07-27
FC_CA01,SKU000323,526,175,351,84,840,2025-07-23
FC_CA01,SKU001437,513,155,358,84,840,2025-07-27
FC_CA01,SKU000855,628,180,448,112,1120,2025-07-25
FC_CA01,SKU000321,1564,505,1059,210,2100,2025-07-27
FC_CA01,SKU001493,876,237,639,140,1400,2025-07-27
FC_CA01,SKU000723,622,189,433,112,1120,2025-07-22
FC_CA01,SKU001635,551,148,403,84,840,2025-07-25
FC_CA01,SKU000051,632,182,450,112,1120,2025-07-27
FC_CA01,SKU001564,629,204,425,112,1120,2025-07-22
FC_CA01,SKU000771,1641,518,1123,210,2100,2025-07-26
FC_CA01,SKU000970,1559,473,1086,210,2100,2025-07-23
FC_CA01,SKU001785,1600,491,1109,210,2100,2025-07-27
FC_CA01,SKU000580,619,153,466,112,1120,2025-07-26
FC_CA01,SKU000343,1563,451,1112,210,2100,2025-07-27
FC_CA01,SKU000612,571,182,389,84,840,2025-07-22
FC_CA01,SKU000488,595,178,417,84,840,2025-07-25
FC_CA01,SKU000966,611,173,438,112,1120,2025-07-25
FC_CA01,SKU000054,1606,494,1112,210,2100,2025-07-23
FC_CA01,SKU000561,269,86,183,56,560,2025-07-22
FC_CA01,SKU001048,236,78,158,56,560,2025-07-24
FC_CA01,SKU000931,602,196,406,112,1120,2025-07-25
FC_CA01,SKU001583,554,178,376,84,840,2025-07-21
FC_CA01,SKU001188,860,240,620,140,1400,2025-07-26
FC_CA01,SKU001415,207,87,120,56,560,2025-07-23
FC_CA01,SKU001927,523,167,356,84,840,2025-07-26
FC_CA01,SKU001841,530,167,363,84,840,2025-07-27
FC_CA01,SKU001326,256,72,184,56,560,2025-07-26
FC_CA01,SKU000830,242,89,153,56,560,2025-07-23
FC_CA01,SKU001556,560,171,389,84,840,2025-07-25
FC_CA01,SKU001317,1593,462,1131,210,2100,2025-07-22
FC_CA01,SKU001012,259,70,189,56,560,2025-07-22
FC_CA01,SKU000086,517,163,354,84,840,2025-07-27
FC_CA01,SKU001360,1520,460,1060,210,2100,2025-07-21
FC_CA01,SKU001648,267,67,200,56,560,2025-07-25
FC_CA01,SKU001095,812,246,566,140,1400,2025-07-27
FC_CA01,SKU000565,818,248,570,140,1400,2025-07-24
FC_CA01,SKU001793,551,163,388,84,840,2025-07-25
FC_CA01,SKU000969,269,83,186,56,560,2025-07-21
FC_CA01,SKU001135,836,253,583,140,1400,2025-07-23
FC_CA01,SKU000244,1581,451,1130,210,2100,2025-07-23
FC_CA01,SKU001839,854,249,605,140,1400,2025-07-24
FC_CA01,SKU001601,502,171,331,84,840,2025-07-23
FC_CA01,SKU001762,259,79,180,56,560,2025-07-25
FC_CA01,SKU000375,1567,454,1113,210,2100,2025-07-21
FC_CA01,SKU000903,1563,449,1114,210,2100,2025-07-27
FC_CA01,SKU000152,241,78,163,56,560,2025-07-25
FC_CA01,SKU000910,256,69,187,56,560,2025-07-26
FC_CA01,SKU001993,582,175,407,84,840,2025-07-22
FC_CA01,SKU001240,1590,454,1136,210,2100,2025-07-22
FC_CA01,SKU000992,228,71,157,56,560,2025-07-25
FC_CA01,SKU001109,627,178,449,112,1120,2025-07-26
FC_CA01,SKU000254,785,215,570,140,1400,2025-07-23
FC_CA01,SKU001423,849,246,603,140,1400,2025-07-27
FC_CA01,SKU000005,862,282,580,140,1400,2025-07-22
FC_CA01,SKU000921,530,178,352,84,840,2025-07-21
FC_CA01,SKU001827,858,239,619,140,1400,2025-07-26
FC_CA01,SKU000627,526,173,353,84,840,2025-07-25
FC_CA01,SKU001939,517,170,347,84,840,2025-07-26
FC_CA01,SKU000374,596,155,441,112,1120,2025-07-26
FC_CA01,SKU001368,630,182,448,112,1120,2025-07-26
FC_CA01,SKU001218,847,251,596,140,1400,2025-07-27
FC_CA01,SKU000555,254,78,176,56,560,2025-07-26
FC_CA01,SKU001266,622,205,417,112,1120,2025-07-26
FC_CA01,SKU001968,563,154,409,84,840,2025-07-23
FC_CA01,SKU000015,1535,487,1048,210,2100,2025-07-26
FC_CA01,SKU000261,621,191,430,112,1120,2025-07-21
FC_CA01,SKU001994,813,219,594,140,1400,2025-07-27
FC_CA01,SKU000475,539,154,385,84,840,2025-07-21
FC_CA01,SKU001717,220,61,159,56,560,2025-07-21
FC_CA01,SKU000486,1626,504,1122,210,2100,2025-07-25
FC_CA01,SKU001175,847,235,612,140,1400,2025-07-27
FC_CA01,SKU000272,841,282,559,140,1400,2025-07-26
FC_CA01,SKU000562,861,244,617,140,1400,2025-07-24
FC_CA01,SKU001278,562,170,392,84,840,2025-07-26
FC_CA01,SKU001077,251,73,178,56,560,2025-07-27
FC_CA01,SKU000604,1644,495,1149,210,2100,2025-07-27
FC_CA01,SKU001214,1548,487,1061,210,2100,2025-07-27
FC_CA01,SKU000936,1591,453,1138,210,2100,2025-07-23
FC_CA01,SKU001450,572,184,388,84,840,2025-07-23
FC_CA01,SKU001932,757,220,537,140,1400,2025-07-21
FC_CA01,SKU001569,580,149,431,112,1120,2025-07-25
FC_CA01,SKU001553,570,173,397,84,840,2025-07-23
FC_CA01,SKU000088,845,245,600,140,1400,2025-07-26
FC_CA01,SKU000068,1583,478,1105,210,2100,2025-07-24
FC_CA01,SKU001165,541,175,366,84,840,2025-07-21
FC_CA01,SKU000379,625,176,449,112,1120,2025-07-26
FC_CA01,SKU001581,835,275,560,140,1400,2025-07-22
FC_CA01,SKU000059,544,166,378,84,840,2025-07-24
FC_CA01,SKU001646,491,130,361,84,840,2025-07-22
FC_CA01,SKU000360,268,77,191,56,560,2025-07-25
FC_CA01,SKU000296,243,81,162,56,560,2025-07-22
FC_CA01,SKU001980,843,256,587,140,1400,2025-07-21
FC_CA01,SKU000777,1531,450,1081,210,2100,2025-07-23
FC_CA01,SKU001989,1567,469,1098,210,2100,2025-07-23
FC_CA01,SKU000935,1578,475,1103,210,2100,2025-07-22
FC_CA01,SKU001398,545,137,408,84,840,2025-07-24
FC_CA01,SKU000063,235,88,147,56,560,2025-07-27
FC_CA01,SKU001764,1649,486,1163,210,2100,2025-07-26
FC_CA01,SKU001393,228,71,157,56,560,2025-07-27
FC_CA01,SKU000031,248,68,180,56,560,2025-07-23
FC_CA01,SKU001500,623,166,457,112,1120,2025-07-25
FC_CA01,SKU001813,833,246,587,140,1400,2025-07-25
FC_CA01,SKU001894,534,158,376,84,840,2025-07-22
FC_CA01,SKU000549,561,168,393,84,840,2025-07-27
FC_CA01,SKU001997,564,172,392,84,840,2025-07-27
FC_CA01,SKU000265,842,260,582,140,1400,2025-07-24
FC_CA01,SKU001548,808,244,564,140,1400,2025-07-22
FC_CA01,SKU000885,589,202,387,84,840,2025-07-27
FC_CA01,SKU000938,243,71,172,56,560,2025-07-25
FC_CA01,SKU001024,594,173,421,84,840,2025-07-25
FC_CA01,SKU001288,523,141,382,84,840,2025-07-21
FC_CA01,SKU000200,1596,510,1086,210,2100,2025-07-23
FC_CA01,SKU001481,1623,506,1117,210,2100,2025-07-22
FC_CA01,SKU000991,890,227,663,140,1400,2025-07-24
FC_CA01,SKU000784,583,165,418,84,840,2025-07-21
FC_CA01,SKU001757,1543,436,1107,210,2100,2025-07-25
FC_CA01,SKU001254,1588,472,1116,210,2100,2025-07-23
FC_CA01,SKU000587,843,242,601,140,1400,2025-07-25
FC_CA01,SKU000637,543,161,382,84,840,2025-07-26
FC_CA01,SKU001259,834,243,591,140,1400,2025-07-23
FC_CA01,SKU000220,889,304,585,140,1400,2025-07-24
FC_CA01,SKU001982,824,226,598,140,1400,2025-07-26
FC_CA01,SKU000861,517,148,369,84,840,2025-07-25
FC_CA01,SKU001506,587,193,394,112,1120,2025-07-23
FC_CA01,SKU001008,521,135,386,84,840,2025-07-27
FC_CA01,SKU001684,1478,404,1074,210,2100,2025-07-25
FC_CA01,SKU001956,1600,485,1115,210,2100,2025-07-26
FC_CA01,SKU000787,236,60,176,56,560,2025-07-22
FC_CA01,SKU001552,563,167,396,84,840,2025-07-25
FC_CA01,SKU000833,609,188,421,112,1120,2025-07-27
FC_CA01,SKU001752,253,66,187,56,560,2025-07-24
FC_CA01,SKU000286,850,271,579,140,1400,2025-07-21
FC_CA01,SKU001350,522,144,378,84,840,2025-07-21
FC_CA01,SKU001226,260,88,172,56,560,2025-07-26
FC_CA01,SKU000715,547,154,393,84,840,2025-07-22
FC_CA01,SKU001392,609,164,445,112,1120,2025-07-27
FC_CA01,SKU000527,272,103,169,56,560,2025-07-24
FC_CA01,SKU000629,1655,514,1141,210,2100,2025-07-23
FC_CA01,SKU000737,1577,490,1087,210,2100,2025-07-27
FC_CA01,SKU000592,874,240,634,140,1400,2025-07-25
FC_CA01,SKU000422,277,84,193,56,560,2025-07-27
FC_CA01,SKU000297,668,206,462,112,1120,2025-07-21
FC_CA01,SKU000141,1562,485,1077,210,2100,2025-07-21
FC_CA01,SKU000849,1599,513,1086,210,2100,2025-07-27
FC_CA01,SKU001584,560,186,374,112,1120,2025-07-26
FC_CA01,SKU000372,509,173,336,84,840,2025-07-26
FC_CA01,SKU001768,278,80,198,56,560,2025-07-27
FC_CA01,SKU001652,235,69,166,56,560,2025-07-22
FC_CA01,SKU000822,259,81,178,56,560,2025-07-24
FC_CA01,SKU000264,845,266,579,140,1400,2025-07-24
FC_CA01,SKU000643,838,263,575,140,1400,2025-07-21
FC_CA01,SKU001232,1586,470,1116,210,2100,2025-07-24
FC_CA01,SKU001867,611,174,437,112,1120,2025-07-21
FC_CA01,SKU000033,1554,465,1089,210,2100,2025-07-24
FC_CA01,SKU001797,1612,464,1148,210,2100,2025-07-21
FC_CA01,SKU001385,601,198,403,112,1120,2025-07-24
FC_CA01,SKU000733,562,186,376,84,840,2025-07-27
FC_CA01,SKU000790,231,60,171,56,560,2025-07-26
FC_CA01,SKU000785,544,158,386,84,840,2025-07-23
FC_CA01,SKU001540,868,267,601,140,1400,2025-07-25
FC_CA01,SKU001875,636,192,444,112,1120,2025-07-26
FC_CA01,SKU001197,266,83,183,56,560,2025-07-25
FC_CA01,SKU001921,279,94,185,56,560,2025-07-24
FC_CA01,SKU001747,255,88,167,56,560,2025-07-23
FC_CA01,SKU001914,839,263,576,140,1400,2025-07-24
FC_CA01,SKU000180,810,258,552,140,1400,2025-07-24
FC_CA01,SKU001928,587,178,409,112,1120,2025-07-23
FC_CA01,SKU000974,1631,484,1147,210,2100,2025-07-25
FC_CA01,SKU000040,239,85,154,56,560,2025-07-24
FC_CA01,SKU000874,515,151,364,84,840,2025-07-27
FC_CA01,SKU000633,252,73,179,56,560,2025-07-25
FC_CA01,SKU001567,644,199,445,112,1120,2025-07-22
FC_CA01,SKU001951,1532,444,1088,210,2100,2025-07-21
FC_CA01,SKU000834,614,184,430,112,1120,2025-07-26
FC_CA01,SKU000863,605,158,447,84,840,2025-07-27
FC_CA01,SKU000501,245,91,154,56,560,2025-07-27
FC_CA01,SKU001986,1605,449,1156,210,2100,2025-07-26
FC_CA01,SKU001823,247,73,174,56,560,2025-07-26
FC_CA01,SKU000415,274,96,178,56,560,2025-07-22
FC_CA01,SKU000388,607,183,424,112,1120,2025-07-22
FC_CA01,SKU000355,859,258,601,140,1400,2025-07-22
FC_CA01,SKU000301,625,184,441,112,1120,2025-07-22
FC_CA01,SKU001395,613,175,438,112,1120,2025-07-26
FC_CA01,SKU001751,636,178,458,112,1120,2025-07-24
FC_CA01,SKU001324,609,157,452,112,1120,2025-07-25
FC_CA01,SKU001771,549,161,388,84,840,2025-07-22
FC_CA01,SKU000946,245,83,162,56,560,2025-07-24
FC_CA01,SKU000691,562,165,397,84,840,2025-07-23
FC_CA01,SKU001688,570,165,405,112,1120,2025-07-23
FC_CA01,SKU001312,880,256,624,140,1400,2025-07-21
FC_CA01,SKU000452,791,225,566,140,1400,2025-07-21
FC_CA01,SKU000290,538,163,375,84,840,2025-07-22
FC_CA01,SKU000105,1533,482,1051,210,2100,2025-07-27
FC_CA01,SKU000783,533,162,371,84,840,2025-07-21
FC_CA01,SKU000994,281,100,181,56,560,2025-07-22
FC_CA01,SKU000907,528,156,372,84,840,2025-07-26
FC_CA01,SKU001092,1559,501,1058,210,2100,2025-07-25
FC_CA01,SKU000961,274,74,200,56,560,2025-07-21
FC_CA01,SKU000686,1597,464,1133,210,2100,2025-07-26
FC_CA01,SKU001480,642,216,426,112,1120,2025-07-26
FC_CA01,SKU001065,1562,432,1130,210,2100,2025-07-26
FC_CA01,SKU000292,529,189,340,84,840,2025-07-26
FC_CA01,SKU000313,1670,524,1146,210,2100,2025-07-27
FC_CA01,SKU000325,621,172,449,112,1120,2025-07-23
FC_CA01,SKU001574,280,78,202,56,560,2025-07-27
FC_CA01,SKU001247,842,288,554,140,1400,2025-07-21
FC_CA01,SKU000514,264,66,198,56,560,2025-07-24
FC_CA01,SKU000256,597,205,392,112,1120,2025-07-22
FC_CA01,SKU000280,518,152,366,84,840,2025-07-24
FC_CA01,SKU001524,1511,436,1075,210,2100,2025-07-25
FC_CA01,SKU000057,544,162,382,84,840,2025-07-23
FC_CA01,SKU001604,247,82,165,56,560,2025-07-27
FC_CA01,SKU000389,631,176,455,112,1120,2025-07-25
FC_CA01,SKU000714,264,74,190,56,560,2025-07-21
FC_CA01,SKU000926,248,75,173,56,560,2025-07-22
FC_CA01,SKU001248,616,180,436,112,1120,2025-07-26
FC_CA01,SKU000448,596,172,424,112,1120,2025-07-27
FC_CA01,SKU000965,1607,486,1121,210,2100,2025-07-21
FC_CA01,SKU001576,828,245,583,140,1400,2025-07-22
FC_CA01,SKU001594,835,221,614,140,1400,2025-07-21
FC_CA01,SKU000275,636,215,421,112,1120,2025-07-27
FC_CA01,SKU001862,284,80,204,56,560,2025-07-25
FC_CA01,SKU000172,252,72,180,56,560,2025-07-21
FC_CA01,SKU001510,262,67,195,56,560,2025-07-21
FC_CA01,SKU000484,848,266,582,140,1400,2025-07-21
FC_CA01,SKU000223,243,76,167,56,560,2025-07-25
FC_CA01,SKU000659,245,81,164,56,560,2025-07-21
FC_CA01,SKU000567,508,154,354,84,840,2025-07-25
FC_CA01,SKU000831,825,249,576,140,1400,2025-07-25
FC_CA01,SKU001182,824,231,593,140,1400,2025-07-27
FC_CA01,SKU000181,884,256,628,140,1400,2025-07-25
FC_CA01,SKU001852,872,281,591,140,1400,2025-07-27
FC_CA01,SKU001429,845,226,619,140,1400,2025-07-23
FC_CA01,SKU000651,928,300,628,140,1400,2025-07-22
FC_CA01,SKU001691,825,246,579,140,1400,2025-07-22
FC_CA01,SKU001134,1509,447,1062,210,2100,2025-07-24
FC_CA01,SKU001233,582,169,413,112,1120,2025-07-24
FC_CA01,SKU000927,511,137,374,84,840,2025-07-24
FC_CA01,SKU000364,584,182,402,84,840,2025-07-25
FC_CA01,SKU000558,519,147,372,84,840,2025-07-26
FC_CA01,SKU001573,633,235,398,112,1120,2025-07-25
FC_CA01,SKU000685,527,169,358,84,840,2025-07-23
FC_CA01,SKU001671,558,166,392,112,1120,2025-07-23
FC_CA01,SKU000370,870,255,615,140,1400,2025-07-23
FC_CA01,SKU000434,249,74,175,56,560,2025-07-22
FC_CA01,SKU001052,858,259,599,140,1400,2025-07-22
FC_CA01,SKU000852,233,81,152,56,560,2025-07-24
FC_CA01,SKU000281,1589,455,1134,210,2100,2025-07-27
FC_CA01,SKU001891,254,91,163,56,560,2025-07-24
FC_CA01,SKU001111,838,249,589,140,1400,2025-07-24
FC_CA01,SKU001621,250,62,188,56,560,2025-07-22
FC_CA01,SKU000848,876,236,640,140,1400,2025-07-23
FC_CA01,SKU000305,255,69,186,56,560,2025-07-27
FC_CA01,SKU001205,1612,434,1178,210,2100,2025-07-27
FC_CA01,SKU001463,604,168,436,112,1120,2025-07-25
FC_CA01,SKU001026,1568,462,1106,210,2100,2025-07-22
FC_CA01,SKU000391,1522,461,1061,210,2100,2025-07-26
FC_CA01,SKU000884,630,200,430,112,1120,2025-07-25
FC_CA01,SKU001061,534,174,360,84,840,2025-07-27
FC_CA01,SKU001888,844,268,576,140,1400,2025-07-23
FC_CA01,SKU000657,637,201,436,112,1120,2025-07-23
FC_CA01,SKU000445,887,260,627,140,1400,2025-07-21
FC_CA01,SKU001209,228,69,159,56,560,2025-07-23
FC_CA01,SKU001566,1546,486,1060,210,2100,2025-07-27
FC_CA01,SKU000720,1573,457,1116,210,2100,2025-07-21
FC_CA01,SKU000461,606,182,424,112,1120,2025-07-24
FC_CA01,SKU001703,631,194,437,112,1120,2025-07-26
FC_CA01,SKU000099,853,258,595,140,1400,2025-07-24
FC_CA01,SKU000702,249,82,167,56,560,2025-07-21
FC_CA01,SKU001444,271,94,177,56,560,2025-07-26
FC_CA01,SKU001467,610,207,403,112,1120,2025-07-21
FC_CA01,SKU000535,238,65,173,56,560,2025-07-25
FC_CA01,SKU000675,1554,494,1060,210,2100,2025-07-26
FC_CA01,SKU001579,297,85,212,56,560,2025-07-25
FC_CA01,SKU000820,1526,455,1071,210,2100,2025-07-21
FC_CA01,SKU000752,841,253,588,140,1400,2025-07-21
FC_CA01,SKU000298,630,191,439,112,1120,2025-07-26
FC_CA01,SKU000941,241,69,172,56,560,2025-07-23
FC_CA01,SKU000508,542,170,372,84,840,2025-07-25
FC_CA01,SKU001850,253,78,175,56,560,2025-07-22
FC_CA01,SKU001045,260,80,180,56,560,2025-07-21
FC_CA01,SKU001926,614,192,422,112,1120,2025-07-22
FC_CA01,SKU001887,239,64,175,56,560,2025-07-27
FC_CA01,SKU001228,577,184,393,84,840,2025-07-26
FC_CA01,SKU001633,519,146,373,84,840,2025-07-24
FC_CA01,SKU000984,599,179,420,112,1120,2025-07-21
FC_CA01,SKU000241,1563,465,1098,210,2100,2025-07-27
FC_CA01,SKU001969,626,197,429,112,1120,2025-07-22
FC_CA01,SKU001464,1497,446,1051,210,2100,2025-07-21
FC_CA01,SKU001397,540,151,389,84,840,2025-07-26
FC_CA01,SKU001501,1556,468,1088,210,2100,2025-07-23
FC_CA01,SKU000512,549,148,401,84,840,2025-07-21
FC_CA01,SKU000816,627,178,449,112,1120,2025-07-25
FC_CA01,SKU000322,843,234,609,140,1400,2025-07-23
FC_CA01,SKU000530,617,204,413,112,1120,2025-07-27
FC_CA01,SKU000201,562,181,381,84,840,2025-07-22
FC_CA01,SKU001705,273,69,204,56,560,2025-07-21
FC_CA01,SKU000428,590,188,402,112,1120,2025-07-24
FC_CA01,SKU000662,246,66,180,56,560,2025-07-24
FC_CA01,SKU000924,1617,508,1109,210,2100,2025-07-22
FC_CA01,SKU000440,890,259,631,140,1400,2025-07-27
FC_CA01,SKU001186,497,135,362,84,840,2025-07-26
FC_CA01,SKU000912,239,66,173,56,560,2025-07-27
FC_CA01,SKU001754,530,169,361,84,840,2025-07-27
FC_CA01,SKU001910,1589,483,1106,210,2100,2025-07-25
FC_CA01,SKU000553,824,262,562,140,1400,2025-07-22
FC_CA01,SKU000518,647,209,438,112,1120,2025-07-27
FC_CA01,SKU000144,630,205,425,112,1120,2025-07-27
FC_CA01,SKU000050,553,152,401,84,840,2025-07-23
FC_CA01,SKU000971,1584,464,1120,210,2100,2025-07-21
FC_CA01,SKU001011,763,240,523,140,1400,2025-07-23
FC_CA01,SKU001344,1544,445,1099,210,2100,2025-07-27
FC_CA01,SKU000266,552,159,393,84,840,2025-07-24
FC_CA01,SKU001289,576,181,395,112,1120,2025-07-21
FC_CA01,SKU000846,840,260,580,140,1400,2025-07-25
FC_CA01,SKU001015,244,74,170,56,560,2025-07-22
FC_CA01,SKU001224,561,179,382,84,840,2025-07-21
FC_CA01,SKU000044,265,59,206,56,560,2025-07-27
FC_CA01,SKU000036,799,233,566,140,1400,2025-07-25
FC_CA01,SKU000353,1529,423,1106,210,2100,2025-07-21
FC_CA01,SKU000092,793,242,551,140,1400,2025-07-24
FC_CA01,SKU000189,258,81,177,56,560,2025-07-25
FC_CA01,SKU000764,640,186,454,112,1120,2025-07-21
FC_CA01,SKU000335,599,190,409,112,1120,2025-07-27
FC_CA01,SKU000498,242,62,180,56,560,2025-07-23
FC_CA01,SKU001602,846,256,590,140,1400,2025-07-22
FC_CA01,SKU000166,636,192,444,112,1120,2025-07-27
FC_CA01,SKU001516,886,268,618,140,1400,2025-07-22
FC_CA01,SKU001597,893,248,645,140,1400,2025-07-22
FC_CA01,SKU000318,540,156,384,84,840,2025-07-25
FC_CA01,SKU001816,238,66,172,56,560,2025-07-21
FC_CA01,SKU000365,1592,457,1135,210,2100,2025-07-24
FC_CA01,SKU000823,886,251,635,140,1400,2025-07-27
FC_CA01,SKU000328,853,263,590,140,1400,2025-07-25
FC_CA01,SKU000990,261,79,182,56,560,2025-07-27
FC_CA01,SKU000188,508,153,355,84,840,2025-07-27
FC_CA01,SKU000667,255,72,183,56,560,2025-07-26
FC_CA01,SKU001441,572,146,426,84,840,2025-07-24
FC_CA01,SKU001844,617,194,423,112,1120,2025-07-24
FC_CA01,SKU000336,563,167,396,84,840,2025-07-27
FC_CA01,SKU001222,274,66,208,56,560,2025-07-21
FC_CA01,SKU001731,1546,474,1072,210,2100,2025-07-27
FC_CA01,SKU001834,251,66,185,56,560,2025-07-24
FC_CA01,SKU000763,838,240,598,140,1400,2025-07-24
FC_CA01,SKU000904,249,75,174,56,560,2025-07-21
FC_CA01,SKU001924,845,266,579,140,1400,2025-07-23
FC_CA01,SKU001096,849,247,602,140,1400,2025-07-27
FC_CA01,SKU001474,1588,474,1114,210,2100,2025-07-26
FC_CA01,SKU000417,258,72,186,56,560,2025-07-25
FC_CA01,SKU001814,875,261,614,140,1400,2025-07-24
FC_CA01,SKU000002,534,162,372,84,840,2025-07-26
FC_CA01,SKU000231,821,231,590,140,1400,2025-07-21
FC_CA01,SKU000703,545,170,375,84,840,2025-07-23
FC_CA01,SKU000989,606,183,423,112,1120,2025-07-27
FC_CA01,SKU001729,256,62,194,56,560,2025-07-21
FC_CA01,SKU001404,1612,488,1124,210,2100,2025-07-25
FC_CA01,SKU001843,597,171,426,112,1120,2025-07-24
FC_CA01,SKU000942,641,182,459,112,1120,2025-07-27
FC_CA01,SKU000718,544,183,361,84,840,2025-07-26
FC_CA01,SKU000529,515,144,371,84,840,2025-07-24
FC_CA01,SKU000062,248,71,177,56,560,2025-07-27
FC_CA01,SKU001499,1641,514,1127,210,2100,2025-07-26
FC_CA01,SKU000805,853,268,585,140,1400,2025-07-21
FC_CA01,SKU001076,577,176,401,112,1120,2025-07-25
FC_CA01,SKU001417,1579,481,1098,210,2100,2025-07-25
FC_CA01,SKU001738,1509,449,1060,210,2100,2025-07-25
FC_CA01,SKU001371,498,125,373,84,840,2025-07-22
FC_CA01,SKU001051,517,149,368,84,840,2025-07-23
FC_CA01,SKU000905,529,169,360,84,840,2025-07-21
FC_CA01,SKU000442,261,75,186,56,560,2025-07-21
FC_CA01,SKU000069,1612,514,1098,210,2100,2025-07-25
FC_CA01,SKU001689,857,275,582,140,1400,2025-07-25
FC_CA01,SKU001790,275,88,187,56,560,2025-07-21
FC_CA01,SKU001526,863,266,597,140,1400,2025-07-24
FC_CA01,SKU001121,255,81,174,56,560,2025-07-24
FC_CA01,SKU000469,1568,481,1087,210,2100,2025-07-25
FC_CA01,SKU001124,631,201,430,112,1120,2025-07-22
FC_CA01,SKU000881,852,254,598,140,1400,2025-07-25
FC_CA01,SKU001775,607,159,448,112,1120,2025-07-21
FC_CA01,SKU000541,556,166,390,84,840,2025-07-22
FC_CA01,SKU001709,262,76,186,56,560,2025-07-22
FC_CA01,SKU000668,863,241,622,140,1400,2025-07-23
FC_CA01,SKU000140,253,85,168,56,560,2025-07-25
FC_CA01,SKU000613,245,78,167,56,560,2025-07-21
FC_CA01,SKU000634,1587,463,1124,210,2100,2025-07-26
FC_CA01,SKU000207,1553,473,1080,210,2100,2025-07-25
FC_CA01,SKU001142,1564,501,1063,210,2100,2025-07-25
FC_CA01,SKU001620,888,243,645,140,1400,2025-07-25
FC_CA01,SKU001221,603,175,428,112,1120,2025-07-26
FC_CA01,SKU000913,1611,486,1125,210,2100,2025-07-21
FC_CA01,SKU000227,249,90,159,56,560,2025-07-25
FC_CA01,SKU001151,621,192,429,112,1120,2025-07-21
FC_CA01,SKU000932,477,131,346,84,840,2025-07-25
FC_CA01,SKU001984,532,139,393,84,840,2025-07-21
FC_CA01,SKU001181,570,187,383,84,840,2025-07-27
FC_CA01,SKU000257,621,187,434,112,1120,2025-07-25
FC_CA01,SKU001334,228,76,152,56,560,2025-07-25
FC_CA01,SKU001204,259,78,181,56,560,2025-07-26
FC_CA01,SKU001865,829,244,585,140,1400,2025-07-26
FC_CA01,SKU000157,548,186,362,84,840,2025-07-25
FC_CA01,SKU001639,1600,495,1105,210,2100,2025-07-26
FC_CA01,SKU001990,621,190,431,112,1120,2025-07-27
FC_CA01,SKU001251,272,90,182,56,560,2025-07-27
FC_CA01,SKU000557,547,173,374,84,840,2025-07-23
FC_CA01,SKU000429,1567,497,1070,210,2100,2025-07-26
FC_CA01,SKU000409,630,185,445,112,1120,2025-07-27
FC_CA01,SKU000341,634,205,429,112,1120,2025-07-24
FC_CA01,SKU001242,843,238,605,140,1400,2025-07-22
FC_CA01,SKU000581,263,94,169,56,560,2025-07-24
FC_CA01,SKU001079,265,84,181,56,560,2025-07-26
FC_CA01,SKU001122,638,186,452,112,1120,2025-07-24
FC_CA01,SKU000523,603,175,428,112,1120,2025-07-23
FC_CA01,SKU001190,244,66,178,56,560,2025-07-26
FC_CA01,SKU000362,601,160,441,112,1120,2025-07-22
FC_CA01,SKU000600,833,272,561,140,1400,2025-07-27
FC_CA01,SKU001722,265,74,191,56,560,2025-07-21
FC_CA01,SKU000513,885,290,595,140,1400,2025-07-23
FC_CA01,SKU000602,250,63,187,56,560,2025-07-24
FC_CA01,SKU001972,255,83,172,56,560,2025-07-22
FC_CA01,SKU001365,1665,521,1144,210,2100,2025-07-22
FC_CA01,SKU000191,1563,440,1123,210,2100,2025-07-27
FC_CA01,SKU000632,808,269,539,140,1400,2025-07-25
FC_CA01,SKU001647,512,161,351,84,840,2025-07-21
FC_CA01,SKU000814,1586,469,1117,210,2100,2025-07-22
FC_CA01,SKU001787,782,215,567,140,1400,2025-07-21
FC_CA01,SKU000023,640,237,403,112,1120,2025-07-22
FC_CA01,SKU000670,513,139,374,84,840,2025-07-26
FC_CA01,SKU001364,543,162,381,84,840,2025-07-26
FC_CA01,SKU001230,611,172,439,112,1120,2025-07-24
FC_CA01,SKU000729,866,288,578,140,1400,2025-07-27
FC_CA01,SKU001383,258,92,166,56,560,2025-07-21
FC_CA01,SKU001943,1569,473,1096,210,2100,2025-07-24
FC_CA01,SKU001810,637,219,418,112,1120,2025-07-23
FC_CA01,SKU001201,621,178,443,112,1120,2025-07-24
FC_CA01,SKU001905,1556,445,1111,210,2100,2025-07-23
FC_CA01,SKU001002,852,250,602,140,1400,2025-07-23
FC_CA01,SKU000174,526,174,352,84,840,2025-07-21
FC_CA01,SKU001714,646,188,458,112,1120,2025-07-22
FC_CA01,SKU001020,225,58,167,56,560,2025-07-21
FC_CA01,SKU001743,879,285,594,140,1400,2025-07-21
FC_CA01,SKU000082,568,177,391,112,1120,2025-07-22
FC_CA01,SKU001298,252,80,172,56,560,2025-07-26
FC_CA01,SKU000640,258,73,185,56,560,2025-07-26
FC_CA01,SKU001619,860,260,600,140,1400,2025-07-22
FC_CA01,SKU001129,852,262,590,140,1400,2025-07-23
FC_CA01,SKU001434,260,96,164,56,560,2025-07-26
FC_CA01,SKU001060,1575,442,1133,210,2100,2025-07-26
FC_CA01,SKU000511,262,85,177,56,560,2025-07-23
FC_CA01,SKU000228,607,166,441,112,1120,2025-07-27
FC_CA01,SKU001934,1588,487,1101,210,2100,2025-07-22
FC_CA01,SKU001931,535,157,378,84,840,2025-07-23
FC_CA01,SKU001078,841,252,589,140,1400,2025-07-24
FC_CA01,SKU000136,267,95,172,56,560,2025-07-21
FC_CA01,SKU001019,1613,482,1131,210,2100,2025-07-27
FC_CA01,SKU001533,637,188,449,112,1120,2025-07-23
FC_CA01,SKU001799,1506,445,1061,210,2100,2025-07-22
FC_CA01,SKU001822,1537,487,1050,210,2100,2025-07-24
FC_CA01,SKU001666,1616,518,1098,210,2100,2025-07-25
FC_CA01,SKU000255,832,258,574,140,1400,2025-07-22
FC_CA01,SKU001127,580,167,413,112,1120,2025-07-24
FC_CA01,SKU001817,542,162,380,84,840,2025-07-26
FC_CA01,SKU000102,289,76,213,56,560,2025-07-27
FC_CA01,SKU001767,245,68,177,56,560,2025-07-21
FC_CA01,SKU001521,575,171,404,84,840,2025-07-23
FC_CA01,SKU000653,252,76,176,56,560,2025-07-24
FC_CA01,SKU000075,1569,431,1138,210,2100,2025-07-25
FC_CA01,SKU001272,560,168,392,84,840,2025-07-23
FC_CA01,SKU000552,1577,490,1087,210,2100,2025-07-23
FC_CA01,SKU000744,823,243,580,140,1400,2025-07-23
FC_CA01,SKU000741,266,93,173,56,560,2025-07-27
FC_CA01,SKU000521,631,201,430,112,1120,2025-07-26
FC_CA01,SKU000708,825,270,555,140,1400,2025-07-24
FC_CA01,SKU000895,595,158,437,84,840,2025-07-22
FC_CA01,SKU001025,275,78,197,56,560,2025-07-25
FC_CA01,SKU001058,252,65,187,56,560,2025-07-26
FC_CA01,SKU001277,778,247,531,140,1400,2025-07-24
FC_CA01,SKU000006,857,283,574,140,1400,2025-07-25
FC_CA01,SKU001801,820,225,595,140,1400,2025-07-27
FC_CA01,SKU000234,569,181,388,84,840,2025-07-25
FC_CA01,SKU000809,636,198,438,112,1120,2025-07-26
FC_CA01,SKU001558,858,260,598,140,1400,2025-07-27
FC_CA01,SKU000358,242,80,162,56,560,2025-07-21
FC_CA01,SKU000125,1542,464,1078,210,2100,2025-07-25
FC_CA01,SKU001608,635,199,436,112,1120,2025-07-27
FC_CA01,SKU001630,590,206,384,112,1120,2025-07-21
FC_CA01,SKU001864,529,162,367,84,840,2025-07-21
FC_CA01,SKU000303,241,94,147,56,560,2025-07-21
FC_CA01,SKU000456,244,72,172,56,560,2025-07-25
FC_CA01,SKU000349,618,176,442,112,1120,2025-07-27
FC_CA01,SKU000232,584,185,399,112,1120,2025-07-27
FC_CA01,SKU000246,837,239,598,140,1400,2025-07-25
FC_CA01,SKU001612,566,147,419,84,840,2025-07-23
FC_CA01,SKU000371,616,211,405,112,1120,2025-07-27
FC_CA01,SKU000470,586,155,431,84,840,2025-07-22
FC_CA01,SKU001457,1539,476,1063,210,2100,2025-07-24
FC_CA01,SKU001348,846,257,589,140,1400,2025-07-26
FC_CA01,SKU000940,638,178,460,112,1120,2025-07-25
FC_CA01,SKU001087,237,74,163,56,560,2025-07-21
FC_CA01,SKU000013,647,205,442,112,1120,2025-07-22
FC_CA01,SKU001018,561,183,378,84,840,2025-07-24
FC_CA01,SKU000357,1554,463,1091,210,2100,2025-07-24
FC_CA01,SKU001282,841,266,575,140,1400,2025-07-23
FC_CA01,SKU001903,241,85,156,56,560,2025-07-27
FC_CA01,SKU001565,556,154,402,84,840,2025-07-25
FC_CA01,SKU001260,847,245,602,140,1400,2025-07-26
FC_CA01,SKU000373,252,66,186,56,560,2025-07-27
FC_CA01,SKU000819,868,252,616,140,1400,2025-07-22
FC_CA01,SKU000310,852,255,597,140,1400,2025-07-27
FC_CA01,SKU001668,257,75,182,56,560,2025-07-21
FC_CA01,SKU001110,246,80,166,56,560,2025-07-26
FC_CA01,SKU001200,624,172,452,112,1120,2025-07-26
FC_CA01,SKU001616,241,78,163,56,560,2025-07-24
FC_CA01,SKU000496,548,156,392,84,840,2025-07-22
FC_CA01,SKU000225,795,265,530,140,1400,2025-07-24
FC_CA01,SKU000949,850,267,583,140,1400,2025-07-27
FC_CA01,SKU000490,622,182,440,112,1120,2025-07-27
FC_CA01,SKU000121,544,139,405,84,840,2025-07-22
FC_CA01,SKU001353,910,298,612,140,1400,2025-07-25
FC_CA01,SKU001176,1649,522,1127,210,2100,2025-07-22
FC_CA01,SKU000937,274,90,184,56,560,2025-07-24
FC_CA01,SKU001824,653,201,452,112,1120,2025-07-24
FC_CA01,SKU000772,245,76,169,56,560,2025-07-26
FC_CA01,SKU000406,544,173,371,84,840,2025-07-25
FC_CA01,SKU000607,603,178,425,84,840,2025-07-22
FC_CA01,SKU000431,798,247,551,140,1400,2025-07-25
FC_CA01,SKU001786,262,73,189,56,560,2025-07-24
FC_CA01,SKU000806,551,181,370,84,840,2025-07-22
FC_CA01,SKU000485,516,155,361,84,840,2025-07-26
FC_CA01,SKU000492,813,240,573,140,1400,2025-07-22
FC_CA01,SKU000681,1625,470,1155,210,2100,2025-07-21
FC_CA01,SKU001265,840,250,590,140,1400,2025-07-21
FC_CA01,SKU000016,622,174,448,112,1120,2025-07-25
FC_CA01,SKU001144,562,185,377,84,840,2025-07-25
FC_CA01,SKU000390,1626,462,1164,210,2100,2025-07-26
FC_CA01,SKU001987,231,73,158,56,560,2025-07-22
FC_CA01,SKU000446,1631,527,1104,210,2100,2025-07-25
FC_CA01,SKU001336,625,185,440,112,1120,2025-07-25
FC_CA01,SKU000982,270,86,184,56,560,2025-07-26
FC_CA01,SKU000757,261,64,197,56,560,2025-07-27
FC_CA01,SKU001539,608,198,410,112,1120,2025-07-27
FC_CA01,SKU000677,268,70,198,56,560,2025-07-25
FC_CA01,SKU001276,639,200,439,112,1120,2025-07-24
FC_CA01,SKU000221,1613,495,1118,210,2100,2025-07-24
FC_CA01,SKU001716,813,247,566,140,1400,2025-07-25
FC_CA01,SKU000993,593,206,387,112,1120,2025-07-23
FC_CA01,SKU001812,819,253,566,140,1400,2025-07-25
FC_CA01,SKU000996,851,257,594,140,1400,2025-07-23
FC_CA01,SKU001541,1553,481,1072,210,2100,2025-07-27
FC_CA01,SKU000837,849,255,594,140,1400,2025-07-27
FC_CA01,SKU000158,561,174,387,84,840,2025-07-26
FC_CA01,SKU000011,543,163,380,84,840,2025-07-26
FC_CA01,SKU001571,1587,467,1120,210,2100,2025-07-25
FC_CA01,SKU000619,1621,480,1141,210,2100,2025-07-25
FC_CA01,SKU001199,275,80,195,56,560,2025-07-21
FC_CA01,SKU000857,1592,499,1093,210,2100,2025-07-23
FC_CA01,SKU001262,247,82,165,56,560,2025-07-23
FC_CA01,SKU001750,1545,468,1077,210,2100,2025-07-24
FC_CA01,SKU001159,553,150,403,84,840,2025-07-24
FC_CA01,SKU001706,264,80,184,56,560,2025-07-22
FC_CA01,SKU000638,833,243,590,140,1400,2025-07-23
FC_CA01,SKU000939,641,197,444,112,1120,2025-07-27
FC_CA01,SKU000597,569,184,385,84,840,2025-07-22
FC_CA01,SKU001067,1594,465,1129,210,2100,2025-07-26
FC_CA01,SKU000920,239,57,182,56,560,2025-07-23
FC_CA01,SKU001870,251,66,185,56,560,2025-07-23
FC_CA01,SKU000958,585,177,408,112,1120,2025-07-25
FC_CA01,SKU001830,261,98,163,56,560,2025-07-26
FC_CA01,SKU000922,263,79,184,56,560,2025-07-24
FC_CA01,SKU001988,851,224,627,140,1400,2025-07-27
FC_CA01,SKU001721,810,240,570,140,1400,2025-07-24
FC_CA01,SKU001791,851,263,588,140,1400,2025-07-22
FC_CA01,SKU001270,1621,509,1112,210,2100,2025-07-27
FC_CA01,SKU000108,1615,478,1137,210,2100,2025-07-25
FC_CA01,SKU001783,799,227,572,140,1400,2025-07-22
FC_CA01,SKU001470,836,229,607,140,1400,2025-07-24
FC_CA01,SKU000258,1525,429,1096,210,2100,2025-07-25
FC_CA01,SKU001090,249,86,163,56,560,2025-07-22
FC_CA01,SKU000746,858,246,612,140,1400,2025-07-27
FC_CA01,SKU000083,852,263,589,140,1400,2025-07-27
FC_CA01,SKU000066,238,86,152,56,560,2025-07-23
FC_CA01,SKU000503,252,61,191,56,560,2025-07-25
FC_CA01,SKU001021,546,174,372,84,840,2025-07-23
FC_CA01,SKU000153,636,191,445,112,1120,2025-07-25
FC_CA01,SKU000269,261,78,183,56,560,2025-07-27
FC_CA01,SKU001246,1543,440,1103,210,2100,2025-07-21
FC_CA01,SKU000506,639,190,449,112,1120,2025-07-25
FC_CA01,SKU000696,1591,463,1128,210,2100,2025-07-23
FC_CA01,SKU000463,273,88,185,56,560,2025-07-23
FC_CA01,SKU000134,1578,490,1088,210,2100,2025-07-22
FC_CA01,SKU001261,268,79,189,56,560,2025-07-25
FC_CA01,SKU000516,635,200,435,112,1120,2025-07-21
FC_CA01,SKU000589,632,198,434,112,1120,2025-07-23
FC_CA01,SKU001878,275,85,190,56,560,2025-07-21
FC_CA01,SKU001941,569,194,375,112,1120,2025-07-23
FC_CA01,SKU001037,610,191,419,112,1120,2025-07-25
FC_CA01,SKU001396,644,178,466,112,1120,2025-07-26
FC_CA01,SKU001897,228,66,162,56,560,2025-07-22
FC_CA01,SKU001728,556,155,401,84,840,2025-07-22
FC_CA01,SKU001374,544,175,369,84,840,2025-07-26
FC_CA01,SKU000893,573,163,410,84,840,2025-07-21
FC_CA01,SKU000331,1537,434,1103,210,2100,2025-07-22
FC_CA01,SKU001603,235,77,158,56,560,2025-07-26
FC_CA01,SKU001624,1575,459,1116,210,2100,2025-07-27
FC_CA01,SKU000605,569,191,378,84,840,2025-07-24
FC_CA01,SKU000126,1607,489,1118,210,2100,2025-07-26
FC_CA01,SKU000329,587,149,438,84,840,2025-07-23
FC_CA01,SKU001609,1625,511,1114,210,2100,2025-07-24
FC_CA01,SKU001333,1596,470,1126,210,2100,2025-07-24
FC_CA01,SKU001877,837,270,567,140,1400,2025-07-26
FC_CA01,SKU001929,573,159,414,84,840,2025-07-23
FC_CA01,SKU000572,883,262,621,140,1400,2025-07-26
FC_CA01,SKU000879,573,161,412,84,840,2025-07-23
FC_CA01,SKU000532,596,196,400,112,1120,2025-07-23
FC_CA01,SKU000866,656,182,474,112,1120,2025-07-23
FC_CA01,SKU000249,601,202,399,112,1120,2025-07-22
FC_CA01,SKU001040,549,179,370,84,840,2025-07-26
FC_CA01,SKU001361,842,248,594,140,1400,2025-07-25
FC_CA01,SKU000392,571,148,423,112,1120,2025-07-21
FC_CA01,SKU001674,838,271,567,140,1400,2025-07-25
FC_CA01,SKU001577,1500,428,1072,210,2100,2025-07-27
FC_CA01,SKU001596,639,177,462,112,1120,2025-07-22
FC_CA01,SKU001826,640,193,447,112,1120,2025-07-23
FC_CA01,SKU000237,1553,419,1134,210,2100,2025-07-25
FC_CA01,SKU001759,617,168,449,112,1120,2025-07-27
FC_CA01,SKU001605,808,230,578,140,1400,2025-07-27
FC_CA01,SKU001100,624,180,444,112,1120,2025-07-25
FC_CA01,SKU001342,504,162,342,84,840,2025-07-27
FC_CA01,SKU001331,1539,498,1041,210,2100,2025-07-24
FC_CA01,SKU001662,1621,474,1147,210,2100,2025-07-23
FC_CA01,SKU001665,518,155,363,84,840,2025-07-22
FC_CA01,SKU001034,864,283,581,140,1400,2025-07-23
FC_CA01,SKU001774,1606,444,1162,210,2100,2025-07-24
FC_CA01,SKU001876,575,147,428,84,840,2025-07-27
FC_CA01,SKU001935,527,159,368,84,840,2025-07-24
FC_CA01,SKU001346,819,243,576,140,1400,2025-07-21
FC_CA01,SKU000842,623,180,443,112,1120,2025-07-27
FC_CA01,SKU000204,528,160,368,84,840,2025-07-26
FC_CA01,SKU000295,839,247,592,140,1400,2025-07-24
FC_CA01,SKU000968,1558,488,1070,210,2100,2025-07-26
FC_CA01,SKU001599,614,179,435,112,1120,2025-07-24
FC_CA01,SKU000399,620,207,413,112,1120,2025-07-21
FC_CA01,SKU001274,1611,488,1123,210,2100,2025-07-26
FC_CA01,SKU000586,628,205,423,112,1120,2025-07-23
FC_CA01,SKU001406,594,185,409,112,1120,2025-07-26
FC_CA01,SKU000004,1522,490,1032,210,2100,2025-07-22
FC_CA01,SKU001355,232,72,160,56,560,2025-07-27
FC_CA01,SKU001522,617,193,424,112,1120,2025-07-26
FC_CA01,SKU000317,597,178,419,112,1120,2025-07-22
FC_CA01,SKU001819,561,150,411,84,840,2025-07-26
FC_CA01,SKU001354,555,167,388,84,840,2025-07-25
FC_CA01,SKU001293,232,72,160,56,560,2025-07-25
FC_CA01,SKU001776,871,281,590,140,1400,2025-07-25
FC_CA01,SKU001979,566,186,380,84,840,2025-07-26
FC_CA01,SKU000047,1567,426,1141,210,2100,2025-07-26
FC_CA01,SKU001561,1609,493,1116,210,2100,2025-07-27
FC_CA01,SKU001549,595,191,404,112,1120,2025-07-21
FC_CA01,SKU001231,826,279,547,140,1400,2025-07-25
FC_CA01,SKU000084,609,183,426,112,1120,2025-07-22
FC_CA01,SKU000882,560,158,402,84,840,2025-07-27
FC_CA01,SKU001835,557,173,384,84,840,2025-07-23
FC_CA01,SKU000354,611,164,447,112,1120,2025-07-24
FC_CA01,SKU000250,638,164,474,112,1120,2025-07-24
FC_CA01,SKU001995,570,166,404,84,840,2025-07-22
FC_CA01,SKU001859,593,181,412,84,840,2025-07-24
FC_CA01,SKU000999,866,276,590,140,1400,2025-07-22
FC_CA01,SKU000433,272,101,171,56,560,2025-07-22
FC_CA01,SKU000116,1622,469,1153,210,2100,2025-07-27
FC_CA01,SKU001836,1534,493,1041,210,2100,2025-07-21
FC_CA01,SKU001239,579,200,379,84,840,2025-07-24
FC_CA01,SKU001983,1537,452,1085,210,2100,2025-07-24
FC_CA01,SKU001103,623,194,429,112,1120,2025-07-25
FC_CA01,SKU001655,621,187,434,112,1120,2025-07-24
FC_CA01,SKU000253,529,163,366,84,840,2025-07-21
FC_CA01,SKU001238,548,139,409,84,840,2025-07-22
FC_CA01,SKU000030,629,182,447,112,1120,2025-07-24
FC_CA01,SKU000983,1557,484,1073,210,2100,2025-07-22
FC_CA01,SKU001241,646,177,469,112,1120,2025-07-25
FC_CA01,SKU001515,1574,437,1137,210,2100,2025-07-22
FC_CA01,SKU000038,1588,495,1093,210,2100,2025-07-27
FC_CA01,SKU000053,533,145,388,84,840,2025-07-26
FC_CA01,SKU001628,582,184,398,112,1120,2025-07-23
FC_CA01,SKU000397,1575,463,1112,210,2100,2025-07-24
FC_WA02,SKU001804,564,167,397,84,840,2025-07-27
FC_WA02,SKU000708,852,265,587,140,1400,2025-07-24
FC_WA02,SKU000905,558,165,393,84,840,2025-07-21
FC_WA02,SKU001154,1571,465,1106,210,2100,2025-07-21
FC_WA02,SKU001464,1601,515,1086,210,2100,2025-07-26
FC_WA02,SKU000074,1531,448,1083,210,2100,2025-07-22
FC_WA02,SKU001482,804,250,554,140,1400,2025-07-26
FC_WA02,SKU000931,607,225,382,112,1120,2025-07-21
FC_WA02,SKU000853,1599,495,1104,210,2100,2025-07-25
FC_WA02,SKU000500,280,73,207,56,560,2025-07-24
FC_WA02,SKU000198,1581,498,1083,210,2100,2025-07-22
FC_WA02,SKU000214,632,193,439,112,1120,2025-07-24
FC_WA02,SKU001345,894,271,623,140,1400,2025-07-24
FC_WA02,SKU001718,531,182,349,84,840,2025-07-24
FC_WA02,SKU001631,777,242,535,140,1400,2025-07-23
FC_WA02,SKU000566,1597,457,1140,210,2100,2025-07-23
FC_WA02,SKU000294,849,224,625,140,1400,2025-07-26
FC_WA02,SKU001857,270,78,192,56,560,2025-07-25
FC_WA02,SKU001188,860,264,596,140,1400,2025-07-23
FC_WA02,SKU000174,606,178,428,84,840,2025-07-21
FC_WA02,SKU001534,1610,456,1154,210,2100,2025-07-22
FC_WA02,SKU000158,535,164,371,84,840,2025-07-25
FC_WA02,SKU001034,826,228,598,140,1400,2025-07-25
FC_WA02,SKU000493,300,74,226,56,560,2025-07-22
FC_WA02,SKU000970,1546,468,1078,210,2100,2025-07-24
FC_WA02,SKU001788,246,73,173,56,560,2025-07-26
FC_WA02,SKU000486,1511,432,1079,210,2100,2025-07-22
FC_WA02,SKU000551,840,249,591,140,1400,2025-07-25
FC_WA02,SKU001233,603,151,452,112,1120,2025-07-24
FC_WA02,SKU001360,1564,469,1095,210,2100,2025-07-21
FC_WA02,SKU001227,1586,488,1098,210,2100,2025-07-25
FC_WA02,SKU000603,554,158,396,84,840,2025-07-26
FC_WA02,SKU000029,1571,439,1132,210,2100,2025-07-23
FC_WA02,SKU001990,670,201,469,112,1120,2025-07-23
FC_WA02,SKU001040,511,153,358,84,840,2025-07-26
FC_WA02,SKU001927,558,202,356,84,840,2025-07-26
FC_WA02,SKU000645,626,190,436,112,1120,2025-07-27
FC_WA02,SKU001045,257,76,181,56,560,2025-07-24
FC_WA02,SKU001530,533,150,383,84,840,2025-07-21
FC_WA02,SKU001614,876,260,616,140,1400,2025-07-22
FC_WA02,SKU000056,545,166,379,84,840,2025-07-23
FC_WA02,SKU000872,825,268,557,140,1400,2025-07-24
FC_WA02,SKU001379,533,164,369,84,840,2025-07-21
FC_WA02,SKU001076,598,178,420,112,1120,2025-07-26
FC_WA02,SKU001185,582,175,407,112,1120,2025-07-27
FC_WA02,SKU000830,252,79,173,56,560,2025-07-21
FC_WA02,SKU000801,255,80,175,56,560,2025-07-21
FC_WA02,SKU000852,243,66,177,56,560,2025-07-21
FC_WA02,SKU001862,248,82,166,56,560,2025-07-26
FC_WA02,SKU000473,866,283,583,140,1400,2025-07-22
FC_WA02,SKU001957,1618,474,1144,210,2100,2025-07-27
FC_WA02,SKU000058,638,191,447,112,1120,2025-07-25
FC_WA02,SKU001838,1598,463,1135,210,2100,2025-07-26
FC_WA02,SKU000702,244,63,181,56,560,2025-07-22
FC_WA02,SKU000233,612,176,436,112,1120,2025-07-24
FC_WA02,SKU000422,265,77,188,56,560,2025-07-25
FC_WA02,SKU001546,254,81,173,56,560,2025-07-22
FC_WA02,SKU000026,617,198,419,112,1120,2025-07-24
FC_WA02,SKU000824,1541,427,1114,210,2100,2025-07-25
FC_WA02,SKU001940,1611,533,1078,210,2100,2025-07-22
FC_WA02,SKU001226,253,67,186,56,560,2025-07-24
FC_WA02,SKU001321,848,238,610,140,1400,2025-07-25
FC_WA02,SKU000234,534,143,391,84,840,2025-07-24
FC_WA02,SKU000116,1561,448,1113,210,2100,2025-07-27
FC_WA02,SKU001895,613,194,419,112,1120,2025-07-23
FC_WA02,SKU001110,261,83,178,56,560,2025-07-27
FC_WA02,SKU001249,648,166,482,112,1120,2025-07-26
FC_WA02,SKU000125,1578,462,1116,210,2100,2025-07-23
FC_WA02,SKU001162,647,180,467,112,1120,2025-07-25
FC_WA02,SKU001800,842,216,626,140,1400,2025-07-27
FC_WA02,SKU001938,1602,465,1137,210,2100,2025-07-21
FC_WA02,SKU000328,834,236,598,140,1400,2025-07-26
FC_WA02,SKU000424,618,183,435,112,1120,2025-07-23
FC_WA02,SKU000014,802,232,570,140,1400,2025-07-25
FC_WA02,SKU000832,534,157,377,84,840,2025-07-26
FC_WA02,SKU000688,822,242,580,140,1400,2025-07-21
FC_WA02,SKU001725,556,170,386,84,840,2025-07-27
FC_WA02,SKU001210,867,253,614,140,1400,2025-07-21
FC_WA02,SKU001087,228,82,146,56,560,2025-07-27
FC_WA02,SKU001864,538,143,395,84,840,2025-07-24
FC_WA02,SKU001214,1553,441,1112,210,2100,2025-07-23
FC_WA02,SKU001132,579,157,422,112,1120,2025-07-27
FC_WA02,SKU000870,1581,446,1135,210,2100,2025-07-27
FC_WA02,SKU000969,271,92,179,56,560,2025-07-21
FC_WA02,SKU001678,238,61,177,56,560,2025-07-25
FC_WA02,SKU000501,239,76,163,56,560,2025-07-27
FC_WA02,SKU001613,613,211,402,112,1120,2025-07-24
FC_WA02,SKU000525,599,185,414,112,1120,2025-07-27
FC_WA02,SKU001977,659,235,424,112,1120,2025-07-22
FC_WA02,SKU001283,786,221,565,140,1400,2025-07-26
FC_WA02,SKU000313,1608,455,1153,210,2100,2025-07-23
FC_WA02,SKU001202,547,174,373,84,840,2025-07-23
FC_WA02,SKU001781,271,86,185,56,560,2025-07-21
FC_WA02,SKU001676,1620,489,1131,210,2100,2025-07-21
FC_WA02,SKU001124,640,186,454,112,1120,2025-07-26
FC_WA02,SKU000009,553,168,385,84,840,2025-07-21
FC_WA02,SKU001268,268,88,180,56,560,2025-07-24
FC_WA02,SKU000668,810,212,598,140,1400,2025-07-25
FC_WA02,SKU001769,263,72,191,56,560,2025-07-24
FC_WA02,SKU000333,608,186,422,112,1120,2025-07-24
FC_WA02,SKU001393,290,93,197,56,560,2025-07-25
FC_WA02,SKU000998,878,241,637,140,1400,2025-07-21
FC_WA02,SKU000327,830,247,583,140,1400,2025-07-23
FC_WA02,SKU000251,254,84,170,56,560,2025-07-21
FC_WA02,SKU001839,840,298,542,140,1400,2025-07-21
FC_WA02,SKU000478,612,167,445,112,1120,2025-07-25
FC_WA02,SKU000745,614,179,435,112,1120,2025-07-21
FC_WA02,SKU001989,1623,505,1118,210,2100,2025-07-24
FC_WA02,SKU001209,281,84,197,56,560,2025-07-25
FC_WA02,SKU001398,581,184,397,84,840,2025-07-22
FC_WA02,SKU000973,242,81,161,56,560,2025-07-21
FC_WA02,SKU000929,1512,458,1054,210,2100,2025-07-27
FC_WA02,SKU001693,606,187,419,112,1120,2025-07-22
FC_WA02,SKU001619,828,260,568,140,1400,2025-07-27
FC_WA02,SKU000759,536,147,389,84,840,2025-07-26
FC_WA02,SKU000999,875,274,601,140,1400,2025-07-23
FC_WA02,SKU000946,242,77,165,56,560,2025-07-23
FC_WA02,SKU001343,575,161,414,84,840,2025-07-21
FC_WA02,SKU000036,863,267,596,140,1400,2025-07-21
FC_WA02,SKU000509,1518,477,1041,210,2100,2025-07-23
FC_WA02,SKU001548,835,263,572,140,1400,2025-07-26
FC_WA02,SKU000926,256,81,175,56,560,2025-07-25
FC_WA02,SKU001177,554,144,410,84,840,2025-07-23
FC_WA02,SKU001686,605,182,423,112,1120,2025-07-22
FC_WA02,SKU000136,245,62,183,56,560,2025-07-26
FC_WA02,SKU001490,544,159,385,84,840,2025-07-23
FC_WA02,SKU001207,810,247,563,140,1400,2025-07-23
FC_WA02,SKU000661,286,72,214,56,560,2025-07-23
FC_WA02,SKU001736,569,156,413,112,1120,2025-07-27
FC_WA02,SKU000099,801,221,580,140,1400,2025-07-23
FC_WA02,SKU001621,258,69,189,56,560,2025-07-26
FC_WA02,SKU001228,570,163,407,84,840,2025-07-24
FC_WA02,SKU000706,260,70,190,56,560,2025-07-21
FC_WA02,SKU001409,537,154,383,84,840,2025-07-24
FC_WA02,SKU001826,607,191,416,112,1120,2025-07-23
FC_WA02,SKU000023,632,200,432,112,1120,2025-07-22
FC_WA02,SKU001231,854,261,593,140,1400,2025-07-25
FC_WA02,SKU001478,821,241,580,140,1400,2025-07-21
FC_WA02,SKU000559,543,157,386,84,840,2025-07-25
FC_WA02,SKU000499,596,145,451,112,1120,2025-07-21
FC_WA02,SKU000355,833,223,610,140,1400,2025-07-24
FC_WA02,SKU001456,615,201,414,112,1120,2025-07-26
FC_WA02,SKU000993,625,184,441,112,1120,2025-07-23
FC_WA02,SKU001030,644,191,453,112,1120,2025-07-25
FC_WA02,SKU000510,1578,449,1129,210,2100,2025-07-23
FC_WA02,SKU000915,276,89,187,56,560,2025-07-24
FC_WA02,SKU001630,612,183,429,112,1120,2025-07-22
FC_WA02,SKU000259,1523,456,1067,210,2100,2025-07-22
FC_WA02,SKU001503,836,252,584,140,1400,2025-07-26
FC_WA02,SKU000458,232,62,170,56,560,2025-07-25
FC_WA02,SKU001275,232,67,165,56,560,2025-07-24
FC_WA02,SKU000812,822,238,584,140,1400,2025-07-23
FC_WA02,SKU000934,541,167,374,84,840,2025-07-21
FC_WA02,SKU000091,818,226,592,140,1400,2025-07-25
FC_WA02,SKU001055,564,167,397,112,1120,2025-07-23
FC_WA02,SKU001039,640,189,451,112,1120,2025-07-27
FC_WA02,SKU000677,247,71,176,56,560,2025-07-26
FC_WA02,SKU001180,866,229,637,140,1400,2025-07-23
FC_WA02,SKU001421,593,174,419,112,1120,2025-07-24
FC_WA02,SKU000758,558,170,388,84,840,2025-07-25
FC_WA02,SKU000894,584,173,411,112,1120,2025-07-22
FC_WA02,SKU000885,540,142,398,84,840,2025-07-23
FC_WA02,SKU001731,1585,510,1075,210,2100,2025-07-25
FC_WA02,SKU000446,1528,468,1060,210,2100,2025-07-26
FC_WA02,SKU000864,564,160,404,84,840,2025-07-24
FC_WA02,SKU000794,876,234,642,140,1400,2025-07-22
FC_WA02,SKU001595,1667,492,1175,210,2100,2025-07-26
FC_WA02,SKU001113,857,269,588,140,1400,2025-07-21
FC_WA02,SKU000084,603,193,410,112,1120,2025-07-25
FC_WA02,SKU001884,557,162,395,84,840,2025-07-21
FC_WA02,SKU001215,637,186,451,112,1120,2025-07-21
FC_WA02,SKU000938,254,62,192,56,560,2025-07-27
FC_WA02,SKU000873,600,194,406,112,1120,2025-07-26
FC_WA02,SKU000331,1612,479,1133,210,2100,2025-07-22
FC_WA02,SKU000591,230,67,163,56,560,2025-07-26
FC_WA02,SKU000596,552,168,384,84,840,2025-07-24
FC_WA02,SKU001046,626,201,425,112,1120,2025-07-21
FC_WA02,SKU000358,249,75,174,56,560,2025-07-24
FC_WA02,SKU001719,654,200,454,112,1120,2025-07-22
FC_WA02,SKU000052,254,85,169,56,560,2025-07-24
FC_WA02,SKU001775,628,189,439,112,1120,2025-07-23
FC_WA02,SKU000267,597,171,426,112,1120,2025-07-22
FC_WA02,SKU001424,1558,465,1093,210,2100,2025-07-25
FC_WA02,SKU000848,798,263,535,140,1400,2025-07-24
FC_WA02,SKU000089,258,84,174,56,560,2025-07-22
FC_WA02,SKU001171,1617,422,1195,210,2100,2025-07-21
FC_WA02,SKU000232,572,163,409,112,1120,2025-07-22
FC_WA02,SKU001540,836,223,613,140,1400,2025-07-23
FC_WA02,SKU000753,800,228,572,140,1400,2025-07-26
FC_WA02,SKU000533,268,99,169,56,560,2025-07-25
FC_WA02,SKU001301,627,174,453,112,1120,2025-07-26
FC_WA02,SKU000377,500,145,355,84,840,2025-07-24
FC_WA02,SKU000766,282,94,188,56,560,2025-07-21
FC_WA02,SKU000918,649,179,470,112,1120,2025-07-22
FC_WA02,SKU000348,630,178,452,112,1120,2025-07-25
FC_WA02,SKU000835,1588,483,1105,210,2100,2025-07-24
FC_WA02,SKU000621,247,67,180,56,560,2025-07-23
FC_WA02,SKU001609,1603,478,1125,210,2100,2025-07-26
FC_WA02,SKU001887,221,61,160,56,560,2025-07-21
FC_WA02,SKU001476,575,160,415,84,840,2025-07-21
FC_WA02,SKU000991,828,222,606,140,1400,2025-07-26
FC_WA02,SKU000797,1617,490,1127,210,2100,2025-07-22
FC_WA02,SKU000865,1569,499,1070,210,2100,2025-07-27
FC_WA02,SKU000669,232,57,175,56,560,2025-07-27
FC_WA02,SKU001730,228,82,146,56,560,2025-07-23
FC_WA02,SKU000728,843,284,559,140,1400,2025-07-23
FC_WA02,SKU000467,262,78,184,56,560,2025-07-23
FC_WA02,SKU001711,553,166,387,84,840,2025-07-27
FC_WA02,SKU001596,617,204,413,112,1120,2025-07-24
FC_WA02,SKU000109,622,208,414,112,1120,2025-07-23
FC_WA02,SKU001369,864,253,611,140,1400,2025-07-25
FC_WA02,SKU001528,559,156,403,84,840,2025-07-26
FC_WA02,SKU001103,612,186,426,112,1120,2025-07-23
FC_WA02,SKU000674,255,72,183,56,560,2025-07-27
FC_WA02,SKU000101,615,168,447,112,1120,2025-07-24
FC_WA02,SKU000655,1545,463,1082,210,2100,2025-07-27
FC_WA02,SKU000397,1586,470,1116,210,2100,2025-07-24
FC_WA02,SKU001396,622,194,428,112,1120,2025-07-25
FC_WA02,SKU000367,607,160,447,112,1120,2025-07-27
FC_WA02,SKU001105,1614,508,1106,210,2100,2025-07-27
FC_WA02,SKU001169,636,175,461,112,1120,2025-07-23
FC_WA02,SKU000689,239,66,173,56,560,2025-07-22
FC_WA02,SKU001471,850,266,584,140,1400,2025-07-24
FC_WA02,SKU001334,254,85,169,56,560,2025-07-21
FC_WA02,SKU001890,602,157,445,112,1120,2025-07-26
FC_WA02,SKU000475,588,173,415,84,840,2025-07-24
FC_WA02,SKU000954,847,243,604,140,1400,2025-07-26
FC_WA02,SKU000301,597,203,394,112,1120,2025-07-24
FC_WA02,SKU000265,848,250,598,140,1400,2025-07-23
FC_WA02,SKU000564,651,206,445,112,1120,2025-07-24
FC_WA02,SKU000715,518,154,364,84,840,2025-07-26
FC_WA02,SKU001910,1574,483,1091,210,2100,2025-07-26
FC_WA02,SKU001547,1571,488,1083,210,2100,2025-07-25
FC_WA02,SKU000809,622,171,451,112,1120,2025-07-25
FC_WA02,SKU001021,553,168,385,84,840,2025-07-25
FC_WA02,SKU000526,256,92,164,56,560,2025-07-24
FC_WA02,SKU001522,609,183,426,112,1120,2025-07-22
FC_WA02,SKU000687,492,141,351,84,840,2025-07-22
FC_WA02,SKU000995,1537,441,1096,210,2100,2025-07-27
FC_WA02,SKU001518,841,253,588,140,1400,2025-07-27
FC_WA02,SKU001322,1558,469,1089,210,2100,2025-07-25
FC_WA02,SKU001819,567,172,395,84,840,2025-07-26
FC_WA02,SKU001911,517,154,363,84,840,2025-07-23
FC_WA02,SKU001194,561,159,402,84,840,2025-07-27
FC_WA02,SKU000442,241,62,179,56,560,2025-07-23
FC_WA02,SKU000164,632,199,433,112,1120,2025-07-26
FC_WA02,SKU000459,847,234,613,140,1400,2025-07-26
FC_WA02,SKU001516,856,265,591,140,1400,2025-07-25
FC_WA02,SKU001825,539,176,363,84,840,2025-07-26
FC_WA02,SKU001324,597,194,403,112,1120,2025-07-25
FC_WA02,SKU000344,877,267,610,140,1400,2025-07-26
FC_WA02,SKU000601,793,258,535,140,1400,2025-07-21
FC_WA02,SKU000862,551,182,369,84,840,2025-07-23
FC_WA02,SKU000757,261,101,160,56,560,2025-07-21
FC_WA02,SKU000543,873,286,587,140,1400,2025-07-21
FC_WA02,SKU000480,1560,476,1084,210,2100,2025-07-21
FC_WA02,SKU000767,905,243,662,140,1400,2025-07-23
FC_WA02,SKU001767,264,78,186,56,560,2025-07-22
FC_WA02,SKU001205,1548,471,1077,210,2100,2025-07-21
FC_WA02,SKU000339,796,251,545,140,1400,2025-07-23
FC_WA02,SKU000462,1562,446,1116,210,2100,2025-07-23
FC_WA02,SKU000592,783,239,544,140,1400,2025-07-27
FC_WA02,SKU000338,616,170,446,112,1120,2025-07-26
FC_WA02,SKU000436,845,277,568,140,1400,2025-07-25
FC_WA02,SKU000105,1599,450,1149,210,2100,2025-07-23
FC_WA02,SKU001586,1535,481,1054,210,2100,2025-07-24
FC_WA02,SKU000979,823,256,567,140,1400,2025-07-23
FC_WA02,SKU000805,865,294,571,140,1400,2025-07-21
FC_WA02,SKU001832,603,201,402,112,1120,2025-07-24
FC_WA02,SKU001563,607,175,432,112,1120,2025-07-24
FC_WA02,SKU001807,525,159,366,84,840,2025-07-27
FC_WA02,SKU000455,506,153,353,84,840,2025-07-23
FC_WA02,SKU000882,580,181,399,84,840,2025-07-25
FC_WA02,SKU001852,850,238,612,140,1400,2025-07-24
FC_WA02,SKU001820,590,170,420,112,1120,2025-07-25
FC_WA02,SKU001278,550,183,367,84,840,2025-07-26
FC_WA02,SKU001155,559,167,392,84,840,2025-07-24
FC_WA02,SKU001068,511,171,340,84,840,2025-07-27
FC_WA02,SKU000128,653,181,472,112,1120,2025-07-27
FC_WA02,SKU001554,797,233,564,140,1400,2025-07-27
FC_WA02,SKU000192,1670,495,1175,210,2100,2025-07-23
FC_WA02,SKU000489,1517,491,1026,210,2100,2025-07-26
FC_WA02,SKU000967,825,280,545,140,1400,2025-07-27
FC_WA02,SKU001487,555,182,373,84,840,2025-07-23
FC_WA02,SKU001365,1561,481,1080,210,2100,2025-07-27
FC_WA02,SKU001888,863,245,618,140,1400,2025-07-22
FC_WA02,SKU001094,582,177,405,112,1120,2025-07-25
FC_WA02,SKU000010,245,62,183,56,560,2025-07-22
FC_WA02,SKU000951,236,69,167,56,560,2025-07-25
FC_WA02,SKU001481,1527,438,1089,210,2100,2025-07-24
FC_WA02,SKU000964,1633,495,1138,210,2100,2025-07-23
FC_WA02,SKU001803,1567,507,1060,210,2100,2025-07-21
FC_WA02,SKU001827,856,248,608,140,1400,2025-07-23
FC_WA02,SKU000281,1610,470,1140,210,2100,2025-07-25
FC_WA02,SKU001412,568,181,387,84,840,2025-07-24
FC_WA02,SKU000804,234,74,160,56,560,2025-07-25
FC_WA02,SKU001066,576,163,413,84,840,2025-07-23
FC_WA02,SKU000017,563,152,411,84,840,2025-07-21
FC_WA02,SKU001263,794,233,561,140,1400,2025-07-25
FC_WA02,SKU001026,1498,433,1065,210,2100,2025-07-21
FC_WA02,SKU001517,255,66,189,56,560,2025-07-26
FC_WA02,SKU001592,577,170,407,112,1120,2025-07-23
FC_WA02,SKU001942,246,69,177,56,560,2025-07-24
FC_WA02,SKU000274,537,158,379,84,840,2025-07-25
FC_WA02,SKU000755,566,159,407,84,840,2025-07-26
FC_WA02,SKU000288,560,197,363,84,840,2025-07-21
FC_WA02,SKU002000,538,165,373,84,840,2025-07-26
FC_WA02,SKU000666,856,253,603,140,1400,2025-07-27
FC_WA02,SKU000876,846,244,602,140,1400,2025-07-27
FC_WA02,SKU000647,238,71,167,56,560,2025-07-27
FC_WA02,SKU000266,518,146,372,84,840,2025-07-22
FC_WA02,SKU000783,580,182,398,84,840,2025-07-24
FC_WA02,SKU000050,546,173,373,84,840,2025-07-26
FC_WA02,SKU001312,847,266,581,140,1400,2025-07-22
FC_WA02,SKU001869,535,161,374,84,840,2025-07-25
FC_WA02,SKU001297,838,245,593,140,1400,2025-07-26
FC_WA02,SKU001310,242,61,181,56,560,2025-07-24
FC_WA02,SKU000218,1615,463,1152,210,2100,2025-07-26
FC_WA02,SKU001033,883,265,618,140,1400,2025-07-22
FC_WA02,SKU001643,551,196,355,84,840,2025-07-21
FC_WA02,SKU001605,834,243,591,140,1400,2025-07-27
FC_WA02,SKU000220,908,242,666,140,1400,2025-07-21
FC_WA02,SKU001744,591,178,413,112,1120,2025-07-21
FC_WA02,SKU001951,1584,436,1148,210,2100,2025-07-21
FC_WA02,SKU001720,1605,481,1124,210,2100,2025-07-23
FC_WA02,SKU001551,839,276,563,140,1400,2025-07-21
FC_WA02,SKU001975,859,262,597,140,1400,2025-07-22
FC_WA02,SKU001536,269,83,186,56,560,2025-07-23
FC_WA02,SKU000802,522,155,367,84,840,2025-07-22
FC_WA02,SKU000205,1568,471,1097,210,2100,2025-07-22
FC_WA02,SKU001108,229,62,167,56,560,2025-07-23
FC_WA02,SKU001668,244,71,173,56,560,2025-07-25
FC_WA02,SKU000409,613,170,443,112,1120,2025-07-25
FC_WA02,SKU000590,619,156,463,112,1120,2025-07-22
FC_WA02,SKU001150,1594,463,1131,210,2100,2025-07-23
FC_WA02,SKU000337,238,86,152,56,560,2025-07-22
FC_WA02,SKU000914,253,90,163,56,560,2025-07-26
FC_WA02,SKU000656,1547,444,1103,210,2100,2025-07-27
FC_WA02,SKU001520,512,166,346,84,840,2025-07-23
FC_WA02,SKU001527,249,74,175,56,560,2025-07-22
FC_WA02,SKU000461,622,182,440,112,1120,2025-07-23
FC_WA02,SKU000135,551,167,384,84,840,2025-07-22
FC_WA02,SKU000555,227,70,157,56,560,2025-07-27
FC_WA02,SKU000359,848,222,626,140,1400,2025-07-25
FC_WA02,SKU001410,260,80,180,56,560,2025-07-24
FC_WA02,SKU001806,774,248,526,140,1400,2025-07-22
FC_WA02,SKU000923,246,75,171,56,560,2025-07-24
FC_WA02,SKU001457,1568,490,1078,210,2100,2025-07-22
FC_WA02,SKU000343,1594,466,1128,210,2100,2025-07-22
FC_WA02,SKU001998,869,269,600,140,1400,2025-07-25
FC_WA02,SKU001580,556,159,397,84,840,2025-07-23
FC_WA02,SKU001937,267,80,187,56,560,2025-07-22
FC_WA02,SKU000741,261,82,179,56,560,2025-07-26
FC_WA02,SKU001952,852,231,621,140,1400,2025-07-22
FC_WA02,SKU000361,592,181,411,112,1120,2025-07-22
FC_WA02,SKU000350,865,257,608,140,1400,2025-07-24
FC_WA02,SKU001089,534,181,353,84,840,2025-07-24
FC_WA02,SKU001116,555,171,384,84,840,2025-07-24
FC_WA02,SKU000006,835,254,581,140,1400,2025-07-23
FC_WA02,SKU001477,598,144,454,112,1120,2025-07-26
FC_WA02,SKU001221,603,171,432,112,1120,2025-07-22
FC_WA02,SKU000015,1624,466,1158,210,2100,2025-07-25
FC_WA02,SKU001178,1619,455,1164,210,2100,2025-07-21
FC_WA02,SKU000560,258,68,190,56,560,2025-07-24
FC_WA02,SKU001192,797,234,563,140,1400,2025-07-24
FC_WA02,SKU001677,236,68,168,56,560,2025-07-22
FC_WA02,SKU001539,584,174,410,112,1120,2025-07-25
FC_WA02,SKU001430,1573,482,1091,210,2100,2025-07-26
FC_WA02,SKU001578,623,188,435,112,1120,2025-07-27
FC_WA02,SKU001346,866,287,579,140,1400,2025-07-26
FC_WA02,SKU000487,212,69,143,56,560,2025-07-26
FC_WA02,SKU001459,622,172,450,112,1120,2025-07-27
FC_WA02,SKU001013,259,75,184,56,560,2025-07-27
FC_WA02,SKU001470,883,238,645,140,1400,2025-07-21
FC_WA02,SKU000693,255,76,179,56,560,2025-07-21
FC_WA02,SKU000197,1537,444,1093,210,2100,2025-07-22
FC_WA02,SKU001067,1558,461,1097,210,2100,2025-07-25
FC_WA02,SKU001751,607,182,425,112,1120,2025-07-22
FC_WA02,SKU001607,259,72,187,56,560,2025-07-23
FC_WA02,SKU001028,858,246,612,140,1400,2025-07-23
FC_WA02,SKU001112,249,82,167,56,560,2025-07-26
FC_WA02,SKU001639,1585,476,1109,210,2100,2025-07-27
FC_WA02,SKU001741,816,246,570,140,1400,2025-07-24
FC_WA02,SKU000137,1555,481,1074,210,2100,2025-07-23
FC_WA02,SKU000617,241,75,166,56,560,2025-07-23
FC_WA02,SKU000739,814,226,588,140,1400,2025-07-23
FC_WA02,SKU001568,785,249,536,140,1400,2025-07-25
FC_WA02,SKU001006,583,178,405,112,1120,2025-07-23
FC_WA02,SKU001019,1520,433,1087,210,2100,2025-07-25
FC_WA02,SKU001988,848,244,604,140,1400,2025-07-25
FC_WA02,SKU000574,1574,435,1139,210,2100,2025-07-24
FC_WA02,SKU000717,262,74,188,56,560,2025-07-26
FC_WA02,SKU001822,1491,454,1037,210,2100,2025-07-21
FC_WA02,SKU000121,566,144,422,84,840,2025-07-23
FC_WA02,SKU000927,570,166,404,84,840,2025-07-23
FC_WA02,SKU000792,1575,448,1127,210,2100,2025-07-25
FC_WA02,SKU001740,541,182,359,84,840,2025-07-27
FC_WA02,SKU000390,1620,484,1136,210,2100,2025-07-23
FC_WA02,SKU001451,1575,524,1051,210,2100,2025-07-22
FC_WA02,SKU001170,813,236,577,140,1400,2025-07-21
FC_WA02,SKU000258,1598,468,1130,210,2100,2025-07-25
FC_WA02,SKU000200,1593,496,1097,210,2100,2025-07-26
FC_WA02,SKU000450,619,199,420,112,1120,2025-07-22
FC_WA02,SKU001773,269,74,195,56,560,2025-07-27
FC_WA02,SKU001626,1486,485,1001,210,2100,2025-07-26
FC_WA02,SKU000857,1589,500,1089,210,2100,2025-07-24
FC_WA02,SKU001541,1510,471,1039,210,2100,2025-07-23
FC_WA02,SKU001538,854,276,578,140,1400,2025-07-23
FC_WA02,SKU000521,641,168,473,112,1120,2025-07-27
FC_WA02,SKU000553,878,276,602,140,1400,2025-07-22
FC_WA02,SKU000038,1632,486,1146,210,2100,2025-07-25
FC_WA02,SKU000483,246,72,174,56,560,2025-07-24
FC_WA02,SKU001160,535,135,400,84,840,2025-07-25
FC_WA02,SKU001091,1554,442,1112,210,2100,2025-07-25
FC_WA02,SKU000425,846,254,592,140,1400,2025-07-22
FC_WA02,SKU000055,240,62,178,56,560,2025-07-26
FC_WA02,SKU000850,1596,481,1115,210,2100,2025-07-27
FC_WA02,SKU001772,571,184,387,84,840,2025-07-26
FC_WA02,SKU000170,865,275,590,140,1400,2025-07-26
FC_WA02,SKU001732,1537,446,1091,210,2100,2025-07-22
FC_WA02,SKU001828,819,267,552,140,1400,2025-07-25
FC_WA02,SKU001700,535,157,378,84,840,2025-07-21
FC_WA02,SKU000800,534,163,371,84,840,2025-07-23
FC_WA02,SKU000304,834,268,566,140,1400,2025-07-23
FC_WA02,SKU001657,1566,473,1093,210,2100,2025-07-25
FC_WA02,SKU001466,536,208,328,84,840,2025-07-26
FC_WA02,SKU001151,633,175,458,112,1120,2025-07-24
FC_WA02,SKU001296,606,192,414,112,1120,2025-07-21
FC_WA02,SKU001017,881,285,596,140,1400,2025-07-23
FC_WA02,SKU000599,277,82,195,56,560,2025-07-21
FC_WA02,SKU001797,1579,477,1102,210,2100,2025-07-27
FC_WA02,SKU001926,645,197,448,112,1120,2025-07-26
FC_WA02,SKU001262,303,105,198,56,560,2025-07-27
FC_WA02,SKU001276,619,189,430,112,1120,2025-07-21
FC_WA02,SKU000018,1530,482,1048,210,2100,2025-07-25
FC_WA02,SKU001625,854,266,588,140,1400,2025-07-21
FC_WA02,SKU000930,1572,522,1050,210,2100,2025-07-26
FC_WA02,SKU001326,247,75,172,56,560,2025-07-27
FC_WA02,SKU000972,544,158,386,84,840,2025-07-26
FC_WA02,SKU000102,264,91,173,56,560,2025-07-27
FC_WA02,SKU000354,598,210,388,112,1120,2025-07-27
FC_WA02,SKU000336,526,127,399,84,840,2025-07-25
FC_WA02,SKU000694,238,73,165,56,560,2025-07-27
FC_WA02,SKU000892,846,242,604,140,1400,2025-07-27
FC_WA02,SKU001543,558,167,391,84,840,2025-07-27
FC_WA02,SKU000032,576,190,386,84,840,2025-07-23
FC_WA02,SKU000765,650,200,450,112,1120,2025-07-27
FC_WA02,SKU000740,562,149,413,84,840,2025-07-22
FC_WA02,SKU001925,567,148,419,84,840,2025-07-27
FC_WA02,SKU000279,1560,499,1061,210,2100,2025-07-22
FC_WA02,SKU001111,836,267,569,140,1400,2025-07-27
FC_WA02,SKU000388,643,192,451,112,1120,2025-07-24
FC_WA02,SKU000013,604,169,435,112,1120,2025-07-27
FC_WA02,SKU001739,624,200,424,112,1120,2025-07-26
FC_WA02,SKU000167,580,199,381,112,1120,2025-07-24
FC_WA02,SKU000031,251,87,164,56,560,2025-07-25
FC_WA02,SKU001771,497,138,359,84,840,2025-07-22
FC_WA02,SKU000994,274,88,186,56,560,2025-07-23
FC_WA02,SKU000319,258,92,166,56,560,2025-07-23
FC_WA02,SKU000626,588,179,409,112,1120,2025-07-22
FC_WA02,SKU000791,642,218,424,112,1120,2025-07-21
FC_WA02,SKU001356,229,65,164,56,560,2025-07-21
FC_WA02,SKU001353,813,259,554,140,1400,2025-07-22
FC_WA02,SKU000245,840,250,590,140,1400,2025-07-24
FC_WA02,SKU000751,615,197,418,112,1120,2025-07-22
FC_WA02,SKU001189,631,182,449,112,1120,2025-07-25
FC_WA02,SKU001935,526,155,371,84,840,2025-07-25
FC_WA02,SKU000067,1604,514,1090,210,2100,2025-07-22
FC_WA02,SKU000869,499,143,356,84,840,2025-07-27
FC_WA02,SKU001874,1543,484,1059,210,2100,2025-07-24
FC_WA02,SKU001523,1560,460,1100,210,2100,2025-07-27
FC_WA02,SKU001172,822,241,581,140,1400,2025-07-25
FC_WA02,SKU000305,233,72,161,56,560,2025-07-23
FC_WA02,SKU001292,647,200,447,112,1120,2025-07-26
FC_WA02,SKU001918,861,261,600,140,1400,2025-07-23
FC_WA02,SKU000407,646,223,423,112,1120,2025-07-25
FC_WA02,SKU001082,271,94,177,56,560,2025-07-23
FC_WA02,SKU000112,1665,488,1177,210,2100,2025-07-23
FC_WA02,SKU001143,248,75,173,56,560,2025-07-23
FC_WA02,SKU001882,535,157,378,84,840,2025-07-26
FC_WA02,SKU001368,581,156,425,112,1120,2025-07-21
FC_WA02,SKU000008,1606,458,1148,210,2100,2025-07-22
FC_WA02,SKU000667,261,74,187,56,560,2025-07-27
FC_WA02,SKU000318,499,158,341,84,840,2025-07-25
FC_WA02,SKU000177,616,183,433,112,1120,2025-07-25
FC_WA02,SKU001181,563,172,391,84,840,2025-07-26
FC_WA02,SKU001738,1633,450,1183,210,2100,2025-07-27
FC_WA02,SKU000532,588,168,420,112,1120,2025-07-26
FC_WA02,SKU000122,830,225,605,140,1400,2025-07-27
FC_WA02,SKU000380,624,213,411,112,1120,2025-07-25
FC_WA02,SKU000562,840,260,580,140,1400,2025-07-27
FC_WA02,SKU001052,816,219,597,140,1400,2025-07-24
FC_WA02,SKU000825,223,56,167,56,560,2025-07-23
FC_WA02,SKU001531,515,155,360,84,840,2025-07-21
FC_WA02,SKU001216,592,184,408,112,1120,2025-07-22
FC_WA02,SKU000413,565,169,396,112,1120,2025-07-25
FC_WA02,SKU001784,618,136,482,112,1120,2025-07-22
FC_WA02,SKU000466,830,250,580,140,1400,2025-07-21
FC_WA02,SKU000330,1586,467,1119,210,2100,2025-07-21
FC_WA02,SKU001053,575,185,390,84,840,2025-07-25
FC_WA02,SKU000628,252,73,179,56,560,2025-07-25
FC_WA02,SKU000903,1549,489,1060,210,2100,2025-07-22
FC_WA02,SKU000046,824,251,573,140,1400,2025-07-24
FC_WA02,SKU001121,249,53,196,56,560,2025-07-24
FC_WA02,SKU000833,660,200,460,112,1120,2025-07-26
FC_WA02,SKU001329,584,167,417,112,1120,2025-07-23
FC_WA02,SKU001821,258,75,183,56,560,2025-07-25
FC_WA02,SKU001500,605,189,416,112,1120,2025-07-25
FC_WA02,SKU001770,1625,509,1116,210,2100,2025-07-24
FC_WA02,SKU000955,511,182,329,84,840,2025-07-23
FC_WA02,SKU001532,595,177,418,84,840,2025-07-21
FC_WA02,SKU001439,1544,465,1079,210,2100,2025-07-21
FC_WA02,SKU001070,813,257,556,140,1400,2025-07-25
FC_WA02,SKU000764,640,210,430,112,1120,2025-07-25
FC_WA02,SKU000618,529,157,372,84,840,2025-07-26
FC_WA02,SKU000366,1589,507,1082,210,2100,2025-07-27
FC_WA02,SKU000002,550,156,394,84,840,2025-07-21
FC_WA02,SKU000148,1633,508,1125,210,2100,2025-07-21
FC_WA02,SKU000335,597,189,408,112,1120,2025-07-23
FC_WA02,SKU001673,565,169,396,84,840,2025-07-21
FC_WA02,SKU001290,248,78,170,56,560,2025-07-22
FC_WA02,SKU001429,834,256,578,140,1400,2025-07-26
FC_WA02,SKU000204,564,153,411,84,840,2025-07-25
FC_WA02,SKU000649,506,153,353,84,840,2025-07-27
FC_WA02,SKU001158,637,214,423,112,1120,2025-07-26
FC_WA02,SKU001204,225,55,170,56,560,2025-07-21
FC_WA02,SKU000063,238,90,148,56,560,2025-07-27
FC_WA02,SKU001891,258,69,189,56,560,2025-07-27
FC_WA02,SKU001351,879,259,620,140,1400,2025-07-25
FC_WA02,SKU000511,280,81,199,56,560,2025-07-27
FC_WA02,SKU000196,513,182,331,84,840,2025-07-25
FC_WA02,SKU001995,524,153,371,84,840,2025-07-26
FC_WA02,SKU001844,658,203,455,112,1120,2025-07-23
FC_WA02,SKU001394,1573,459,1114,210,2100,2025-07-25
FC_WA02,SKU001218,843,226,617,140,1400,2025-07-27
FC_WA02,SKU001339,872,241,631,140,1400,2025-07-24
FC_WA02,SKU000289,536,163,373,84,840,2025-07-23
FC_WA02,SKU001037,586,167,419,112,1120,2025-07-24
FC_WA02,SKU001675,805,231,574,140,1400,2025-07-22
FC_WA02,SKU000541,568,173,395,84,840,2025-07-23
FC_WA02,SKU000577,803,236,567,140,1400,2025-07-22
FC_WA02,SKU000768,912,256,656,140,1400,2025-07-24
FC_WA02,SKU001914,830,253,577,140,1400,2025-07-27
FC_WA02,SKU000565,850,240,610,140,1400,2025-07-24
FC_WA02,SKU000785,498,162,336,84,840,2025-07-25
FC_WA02,SKU001083,1559,471,1088,210,2100,2025-07-23
FC_WA02,SKU000607,526,176,350,84,840,2025-07-22
FC_WA02,SKU000642,523,151,372,84,840,2025-07-23
FC_WA02,SKU001305,1544,432,1112,210,2100,2025-07-25
FC_WA02,SKU001868,556,175,381,84,840,2025-07-27
FC_WA02,SKU001928,612,194,418,112,1120,2025-07-26
FC_WA02,SKU000178,535,152,383,84,840,2025-07-21
FC_WA02,SKU000726,238,76,162,56,560,2025-07-26
FC_WA02,SKU001493,846,251,595,140,1400,2025-07-22
FC_WA02,SKU000166,594,192,402,112,1120,2025-07-21
FC_WA02,SKU000958,644,197,447,112,1120,2025-07-27
FC_WA02,SKU000924,1540,480,1060,210,2100,2025-07-22
FC_WA02,SKU001461,240,70,170,56,560,2025-07-27
FC_WA02,SKU001594,844,275,569,140,1400,2025-07-21
FC_WA02,SKU000003,595,179,416,112,1120,2025-07-24
FC_WA02,SKU001683,246,62,184,56,560,2025-07-21
FC_WA02,SKU001342,523,171,352,84,840,2025-07-27
FC_WA02,SKU001152,539,171,368,84,840,2025-07-22
FC_WA02,SKU000610,259,82,177,56,560,2025-07-24
FC_WA02,SKU000586,661,168,493,112,1120,2025-07-22
FC_WA02,SKU000448,632,181,451,112,1120,2025-07-24
FC_WA02,SKU001565,571,163,408,84,840,2025-07-22
FC_WA02,SKU001646,521,165,356,84,840,2025-07-24
FC_WA02,SKU000662,264,58,206,56,560,2025-07-21
FC_WA02,SKU000341,608,184,424,112,1120,2025-07-25
FC_WA02,SKU000536,1617,456,1161,210,2100,2025-07-21
FC_WA02,SKU000001,525,161,364,84,840,2025-07-27
FC_WA02,SKU001085,878,297,581,140,1400,2025-07-25
FC_WA02,SKU000858,536,162,374,84,840,2025-07-21
FC_WA02,SKU001847,579,178,401,84,840,2025-07-21
FC_WA02,SKU000373,250,69,181,56,560,2025-07-23
FC_WA02,SKU000606,865,258,607,140,1400,2025-07-24
FC_WA02,SKU000826,834,253,581,140,1400,2025-07-26
FC_WA02,SKU000181,872,252,620,140,1400,2025-07-24
FC_WA02,SKU001201,632,187,445,112,1120,2025-07-22
FC_WA02,SKU001406,627,190,437,112,1120,2025-07-25
FC_WA02,SKU001968,542,157,385,84,840,2025-07-23
FC_WA02,SKU000090,1585,447,1138,210,2100,2025-07-26
FC_WA02,SKU000371,623,189,434,112,1120,2025-07-24
FC_WA02,SKU001641,534,166,368,84,840,2025-07-21
FC_WA02,SKU001062,258,75,183,56,560,2025-07-23
FC_WA02,SKU001259,914,266,648,140,1400,2025-07-23
FC_WA02,SKU000725,619,185,434,112,1120,2025-07-25
FC_WA02,SKU001441,560,173,387,84,840,2025-07-24
FC_WA02,SKU001090,250,85,165,56,560,2025-07-26
FC_WA02,SKU000680,1613,473,1140,210,2100,2025-07-22
FC_WA02,SKU000898,617,166,451,112,1120,2025-07-24
FC_WA02,SKU000567,550,164,386,84,840,2025-07-24
FC_WA02,SKU000827,527,169,358,84,840,2025-07-23
FC_WA02,SKU001378,624,174,450,112,1120,2025-07-27
FC_WA02,SKU001402,534,140,394,84,840,2025-07-23
FC_WA02,SKU000235,824,239,585,140,1400,2025-07-24
FC_WA02,SKU000575,828,249,579,140,1400,2025-07-25
FC_WA02,SKU000363,605,194,411,112,1120,2025-07-23
FC_WA02,SKU001183,542,170,372,84,840,2025-07-25
FC_WA02,SKU001415,260,78,182,56,560,2025-07-21
FC_WA02,SKU001187,246,68,178,56,560,2025-07-24
FC_WA02,SKU000088,843,238,605,140,1400,2025-07-22
FC_WA02,SKU001318,594,185,409,84,840,2025-07-24
FC_WA02,SKU000854,1604,474,1130,210,2100,2025-07-21
FC_WA02,SKU000021,885,249,636,140,1400,2025-07-27
FC_WA02,SKU000445,801,239,562,140,1400,2025-07-22
FC_WA02,SKU000207,1584,485,1099,210,2100,2025-07-26
FC_WA02,SKU001841,583,171,412,84,840,2025-07-24
FC_WA02,SKU001782,820,241,579,140,1400,2025-07-24
FC_WA02,SKU000439,260,73,187,56,560,2025-07-22
FC_WA02,SKU000217,238,70,168,56,560,2025-07-25
FC_WA02,SKU001157,1584,492,1092,210,2100,2025-07-23
FC_WA02,SKU000734,521,185,336,84,840,2025-07-27
FC_WA02,SKU000611,859,276,583,140,1400,2025-07-25
FC_WA02,SKU001694,247,63,184,56,560,2025-07-27
FC_WA02,SKU000201,553,150,403,84,840,2025-07-25
FC_WA02,SKU001980,844,246,598,140,1400,2025-07-23
FC_WA02,SKU001900,537,136,401,84,840,2025-07-26
FC_WA02,SKU001549,629,191,438,112,1120,2025-07-26
FC_WA02,SKU001812,829,237,592,140,1400,2025-07-27
FC_WA02,SKU001661,253,74,179,56,560,2025-07-23
FC_WA02,SKU001022,1561,433,1128,210,2100,2025-07-21
FC_WA02,SKU001526,782,253,529,140,1400,2025-07-27
FC_WA02,SKU000287,580,177,403,84,840,2025-07-22
FC_WA02,SKU000714,234,72,162,56,560,2025-07-27
FC_WA02,SKU000948,1658,513,1145,210,2100,2025-07-27
FC_WA02,SKU001712,595,177,418,112,1120,2025-07-22
FC_WA02,SKU001250,507,147,360,84,840,2025-07-23
FC_WA02,SKU001662,1619,464,1155,210,2100,2025-07-22
FC_WA02,SKU000048,242,82,160,56,560,2025-07-24
FC_WA02,SKU000119,1593,502,1091,210,2100,2025-07-25
FC_WA02,SKU000516,599,168,431,112,1120,2025-07-25
FC_WA02,SKU001208,807,246,561,140,1400,2025-07-22
FC_WA02,SKU000260,802,233,569,140,1400,2025-07-24
FC_WA02,SKU000554,630,204,426,112,1120,2025-07-22
FC_WA02,SKU001510,273,80,193,56,560,2025-07-27
FC_WA02,SKU000308,873,264,609,140,1400,2025-07-21
FC_WA02,SKU001508,863,241,622,140,1400,2025-07-26
FC_WA02,SKU001437,510,152,358,84,840,2025-07-21
FC_WA02,SKU000861,555,155,400,84,840,2025-07-22
FC_WA02,SKU001385,610,168,442,112,1120,2025-07-21
FC_WA02,SKU000773,545,182,363,84,840,2025-07-26
FC_WA02,SKU001311,838,286,552,140,1400,2025-07-21
FC_WA02,SKU001759,676,165,511,112,1120,2025-07-26
FC_WA02,SKU001672,558,179,379,84,840,2025-07-23
FC_WA02,SKU000904,282,76,206,56,560,2025-07-25
FC_WA02,SKU001443,836,252,584,140,1400,2025-07-22
FC_WA02,SKU001573,621,182,439,112,1120,2025-07-24
FC_WA02,SKU000280,546,175,371,84,840,2025-07-21
FC_WA02,SKU001497,585,190,395,112,1120,2025-07-21
FC_WA02,SKU001432,837,240,597,140,1400,2025-07-26
FC_WA02,SKU000974,1584,520,1064,210,2100,2025-07-25
FC_WA02,SKU000909,579,173,406,84,840,2025-07-23
FC_WA02,SKU000491,551,132,419,84,840,2025-07-23
FC_WA02,SKU000505,528,173,355,84,840,2025-07-22
FC_WA02,SKU000428,604,201,403,112,1120,2025-07-26
FC_WA02,SKU001509,612,171,441,112,1120,2025-07-21
FC_WA02,SKU000947,635,176,459,112,1120,2025-07-22
FC_WA02,SKU001130,1586,493,1093,210,2100,2025-07-25
FC_WA02,SKU000189,248,66,182,56,560,2025-07-23
FC_WA02,SKU000546,248,61,187,56,560,2025-07-23
FC_WA02,SKU001392,623,192,431,112,1120,2025-07-27
FC_WA02,SKU001764,1623,463,1160,210,2100,2025-07-26
FC_WA02,SKU001830,276,93,183,56,560,2025-07-21
FC_WA02,SKU000490,622,192,430,112,1120,2025-07-27
FC_WA02,SKU001372,562,181,381,84,840,2025-07-25
FC_WA02,SKU000961,252,75,177,56,560,2025-07-21
FC_WA02,SKU000507,1621,484,1137,210,2100,2025-07-24
FC_WA02,SKU000185,827,281,546,140,1400,2025-07-23
FC_WA02,SKU000860,839,262,577,140,1400,2025-07-26
FC_WA02,SKU000707,236,78,158,56,560,2025-07-26
FC_WA02,SKU000623,791,260,531,140,1400,2025-07-25
FC_WA02,SKU000595,1621,481,1140,210,2100,2025-07-27
FC_WA02,SKU000631,675,196,479,112,1120,2025-07-26
FC_WA02,SKU001144,546,145,401,84,840,2025-07-23
FC_WA02,SKU000518,588,175,413,112,1120,2025-07-25
FC_WA02,SKU000990,269,83,186,56,560,2025-07-23
FC_WA02,SKU001574,252,76,176,56,560,2025-07-26
FC_WA02,SKU000242,274,82,192,56,560,2025-07-22
FC_WA02,SKU000372,581,190,391,84,840,2025-07-26
FC_WA02,SKU001513,1609,491,1118,210,2100,2025-07-22
FC_WA02,SKU000537,615,170,445,112,1120,2025-07-21
FC_WA02,SKU000230,235,72,163,56,560,2025-07-22
FC_WA02,SKU001912,840,261,579,140,1400,2025-07-24
FC_WA02,SKU001309,229,58,171,56,560,2025-07-23
FC_WA02,SKU001883,1589,475,1114,210,2100,2025-07-23
FC_WA02,SKU000011,546,157,389,84,840,2025-07-23
FC_WA02,SKU000211,887,266,621,140,1400,2025-07-21
FC_WA02,SKU000682,532,151,381,84,840,2025-07-21
FC_WA02,SKU000659,232,76,156,56,560,2025-07-23
FC_WA02,SKU000399,650,195,455,112,1120,2025-07-23
FC_WA02,SKU000283,630,182,448,112,1120,2025-07-25
FC_WA02,SKU001973,531,158,373,84,840,2025-07-25
FC_WA02,SKU001027,1561,442,1119,210,2100,2025-07-27
FC_WA02,SKU001375,1533,519,1014,210,2100,2025-07-26
FC_WA02,SKU000481,1629,555,1074,210,2100,2025-07-24
FC_WA02,SKU000202,599,157,442,112,1120,2025-07-26
FC_WA02,SKU000910,257,72,185,56,560,2025-07-24
FC_WA02,SKU001947,525,151,374,84,840,2025-07-21
FC_WA02,SKU001757,1495,442,1053,210,2100,2025-07-23
FC_WA02,SKU001340,773,239,534,140,1400,2025-07-23
FC_WA02,SKU000524,847,272,575,140,1400,2025-07-21
FC_WA02,SKU001362,556,160,396,84,840,2025-07-22
FC_WA02,SKU001280,1563,435,1128,210,2100,2025-07-25
FC_WA02,SKU000548,256,71,185,56,560,2025-07-22
FC_WA02,SKU000374,604,179,425,112,1120,2025-07-26
FC_WA02,SKU001395,577,184,393,112,1120,2025-07-27
FC_WA02,SKU001390,551,160,391,84,840,2025-07-23
FC_WA02,SKU001049,535,147,388,84,840,2025-07-24
FC_WA02,SKU000126,1542,449,1093,210,2100,2025-07-27
FC_WA02,SKU001861,1596,462,1134,210,2100,2025-07-24
FC_WA02,SKU001264,248,88,160,56,560,2025-07-22
FC_WA02,SKU001603,275,88,187,56,560,2025-07-22
FC_WA02,SKU000081,534,171,363,84,840,2025-07-26
FC_WA02,SKU001902,610,175,435,112,1120,2025-07-26
FC_WA02,SKU000718,527,145,382,84,840,2025-07-23
FC_WA02,SKU001320,862,242,620,140,1400,2025-07-22
FC_WA02,SKU000742,251,92,159,56,560,2025-07-25
FC_WA02,SKU000307,861,256,605,140,1400,2025-07-24
FC_WA02,SKU001165,553,166,387,84,840,2025-07-23
FC_WA02,SKU000272,799,258,541,140,1400,2025-07-21
FC_WA02,SKU001279,255,70,185,56,560,2025-07-21
FC_WA02,SKU000155,1552,505,1047,210,2100,2025-07-23
FC_WA02,SKU000349,561,166,395,112,1120,2025-07-24
FC_WA02,SKU001479,639,193,446,112,1120,2025-07-27
FC_WA02,SKU001754,493,145,348,84,840,2025-07-22
FC_WA02,SKU000357,1610,490,1120,210,2100,2025-07-23
FC_WA02,SKU001691,821,257,564,140,1400,2025-07-21
FC_WA02,SKU000132,228,47,181,56,560,2025-07-25
FC_WA02,SKU000978,544,172,372,84,840,2025-07-25
FC_WA02,SKU001589,1586,460,1126,210,2100,2025-07-25
FC_WA02,SKU001566,1556,465,1091,210,2100,2025-07-23
FC_WA02,SKU000971,1555,461,1094,210,2100,2025-07-25
FC_WA02,SKU001955,235,61,174,56,560,2025-07-26
FC_WA02,SKU000828,615,194,421,112,1120,2025-07-27
FC_WA02,SKU001336,616,205,411,112,1120,2025-07-22
FC_WA02,SKU001486,249,74,175,56,560,2025-07-23
FC_WA02,SKU000042,1537,441,1096,210,2100,2025-07-25
FC_WA02,SKU001448,242,85,157,56,560,2025-07-24
FC_WA02,SKU000843,1609,453,1156,210,2100,2025-07-26
FC_WA02,SKU000817,1576,469,1107,210,2100,2025-07-23
FC_WA02,SKU001473,545,149,396,84,840,2025-07-24
FC_WA02,SKU000033,1592,496,1096,210,2100,2025-07-22
FC_WA02,SKU001294,613,184,429,112,1120,2025-07-24
FC_WA02,SKU001702,632,177,455,112,1120,2025-07-24
FC_WA02,SKU001047,816,261,555,140,1400,2025-07-23
FC_WA02,SKU001970,892,250,642,140,1400,2025-07-23
FC_WA02,SKU000195,833,236,597,140,1400,2025-07-27
FC_WA02,SKU000437,1542,493,1049,210,2100,2025-07-22
FC_WA02,SKU001836,1548,457,1091,210,2100,2025-07-23
FC_WA02,SKU001438,816,239,577,140,1400,2025-07-22
FC_WA02,SKU000583,614,177,437,112,1120,2025-07-24
FC_WA02,SKU001252,628,214,414,112,1120,2025-07-23
FC_WA02,SKU001303,1566,478,1088,210,2100,2025-07-24
FC_WA02,SKU001331,1630,502,1128,210,2100,2025-07-27
FC_WA02,SKU000842,611,171,440,112,1120,2025-07-24
FC_WA02,SKU001953,1594,471,1123,210,2100,2025-07-23
FC_WA02,SKU000406,578,193,385,84,840,2025-07-26
FC_WA02,SKU000829,853,288,565,140,1400,2025-07-27
FC_WA02,SKU001281,1583,501,1082,210,2100,2025-07-23
FC_WA02,SKU000496,526,137,389,84,840,2025-07-24
FC_WA02,SKU001618,823,271,552,140,1400,2025-07-25
FC_WA02,SKU000762,851,263,588,140,1400,2025-07-25
FC_WA02,SKU001307,847,247,600,140,1400,2025-07-26
FC_WA02,SKU000173,1544,496,1048,210,2100,2025-07-26
FC_WA02,SKU000502,816,256,560,140,1400,2025-07-24
FC_WA02,SKU000793,270,85,185,56,560,2025-07-27
FC_WA02,SKU001134,1562,450,1112,210,2100,2025-07-23
FC_WA02,SKU000391,1497,430,1067,210,2100,2025-07-23
FC_WA02,SKU001946,909,254,655,140,1400,2025-07-25
FC_WA02,SKU000919,851,275,576,140,1400,2025-07-23
FC_WA02,SKU000045,253,83,170,56,560,2025-07-22
FC_WA02,SKU000064,574,173,401,112,1120,2025-07-27
FC_WA02,SKU001889,1566,440,1126,210,2100,2025-07-21
FC_WA02,SKU001617,552,168,384,84,840,2025-07-25
FC_WA02,SKU001647,548,175,373,84,840,2025-07-24
FC_WA02,SKU001197,253,82,171,56,560,2025-07-21
FC_WA02,SKU000512,553,176,377,84,840,2025-07-26
FC_WA02,SKU001542,868,256,612,140,1400,2025-07-24
FC_WA02,SKU000182,1511,457,1054,210,2100,2025-07-22
FC_WA02,SKU000405,1553,487,1066,210,2100,2025-07-22
FC_WA02,SKU001724,1584,455,1129,210,2100,2025-07-23
FC_WA02,SKU000096,1564,424,1140,210,2100,2025-07-21
FC_WA02,SKU000781,1542,449,1093,210,2100,2025-07-24
FC_WA02,SKU001203,618,189,429,112,1120,2025-07-24
FC_WA02,SKU001304,217,73,144,56,560,2025-07-21
FC_WA02,SKU001246,1614,486,1128,210,2100,2025-07-22
FC_WA02,SKU000520,505,146,359,84,840,2025-07-24
FC_WA02,SKU001916,605,158,447,112,1120,2025-07-24
FC_WA02,SKU001629,242,66,176,56,560,2025-07-26
FC_WA02,SKU001958,639,197,442,112,1120,2025-07-27
FC_WA02,SKU001098,1506,400,1106,210,2100,2025-07-23
FC_WA02,SKU000426,1557,478,1079,210,2100,2025-07-21
FC_WA02,SKU000383,1544,471,1073,210,2100,2025-07-26
FC_WA02,SKU000295,830,235,595,140,1400,2025-07-25
FC_WA02,SKU000342,605,180,425,112,1120,2025-07-21
FC_WA02,SKU001660,562,164,398,84,840,2025-07-22
FC_WA02,SKU001679,1540,466,1074,210,2100,2025-07-25
FC_WA02,SKU001653,1448,448,1000,210,2100,2025-07-23
FC_WA02,SKU000404,643,210,433,112,1120,2025-07-22
FC_WA02,SKU001559,1546,437,1109,210,2100,2025-07-27
FC_WA02,SKU001750,1562,450,1112,210,2100,2025-07-21
FC_WA02,SKU000588,815,236,579,140,1400,2025-07-23
FC_WA02,SKU001436,615,180,435,112,1120,2025-07-24
FC_WA02,SKU001043,240,76,164,56,560,2025-07-27
FC_WA02,SKU000168,833,262,571,140,1400,2025-07-22
FC_WA02,SKU000311,240,74,166,56,560,2025-07-24
FC_WA02,SKU000788,1638,482,1156,210,2100,2025-07-22
FC_WA02,SKU001793,539,147,392,84,840,2025-07-21
FC_WA02,SKU000435,1532,489,1043,210,2100,2025-07-25
FC_WA02,SKU001746,798,240,558,140,1400,2025-07-22
FC_WA02,SKU000149,581,161,420,112,1120,2025-07-25
FC_WA02,SKU001234,605,194,411,112,1120,2025-07-25
FC_WA02,SKU001778,233,78,155,56,560,2025-07-23
FC_WA02,SKU001498,618,172,446,112,1120,2025-07-26
FC_WA02,SKU001787,828,241,587,140,1400,2025-07-24
FC_WA02,SKU000083,867,239,628,140,1400,2025-07-23
FC_WA02,SKU001996,548,190,358,84,840,2025-07-26
FC_WA02,SKU000738,267,98,169,56,560,2025-07-22
FC_WA02,SKU000644,1570,522,1048,210,2100,2025-07-21
FC_WA02,SKU000584,628,196,432,112,1120,2025-07-23
FC_WA02,SKU000597,512,144,368,84,840,2025-07-25
FC_WA02,SKU000334,802,228,574,140,1400,2025-07-24
FC_WA02,SKU000822,260,74,186,56,560,2025-07-24
FC_WA02,SKU001061,567,154,413,84,840,2025-07-24
FC_WA02,SKU001963,560,191,369,84,840,2025-07-23
FC_WA02,SKU000296,243,72,171,56,560,2025-07-25
FC_WA02,SKU001552,489,141,348,84,840,2025-07-26
FC_WA02,SKU000393,234,75,159,56,560,2025-07-26
FC_WA02,SKU000312,806,238,568,140,1400,2025-07-27
FC_WA02,SKU000975,839,265,574,140,1400,2025-07-26
FC_WA02,SKU000156,256,69,187,56,560,2025-07-26
FC_WA02,SKU001308,531,157,374,84,840,2025-07-26
FC_WA02,SKU001004,554,167,387,84,840,2025-07-24
FC_WA02,SKU001127,629,206,423,112,1120,2025-07-25
FC_WA02,SKU000519,236,70,166,56,560,2025-07-26
FC_WA02,SKU000085,839,233,606,140,1400,2025-07-23
FC_WA02,SKU000253,534,173,361,84,840,2025-07-25
FC_WA02,SKU000719,659,190,469,112,1120,2025-07-27
FC_WA02,SKU000244,1547,432,1115,210,2100,2025-07-25
FC_WA02,SKU001349,257,101,156,56,560,2025-07-23
FC_WA02,SKU001109,575,188,387,112,1120,2025-07-21
FC_WA02,SKU001939,582,176,406,84,840,2025-07-22
FC_WA02,SKU001075,598,153,445,112,1120,2025-07-23
FC_WA02,SKU001846,808,234,574,140,1400,2025-07-23
FC_WA02,SKU000902,271,95,176,56,560,2025-07-23
FC_WA02,SKU000378,835,256,579,140,1400,2025-07-22
FC_WA02,SKU000845,559,164,395,84,840,2025-07-26
FC_WA02,SKU001425,621,184,437,112,1120,2025-07-27
FC_WA02,SKU001658,618,165,453,112,1120,2025-07-27
FC_WA02,SKU001583,522,164,358,84,840,2025-07-22
FC_WA02,SKU001240,1592,494,1098,210,2100,2025-07-22
FC_WA02,SKU000795,818,242,576,140,1400,2025-07-26
FC_WA02,SKU001029,638,184,454,112,1120,2025-07-21
FC_WA02,SKU000469,1604,492,1112,210,2100,2025-07-23
FC_WA02,SKU000962,539,167,372,84,840,2025-07-26
FC_WA02,SKU000191,1599,464,1135,210,2100,2025-07-26
FC_WA02,SKU000381,890,237,653,140,1400,2025-07-22
FC_WA02,SKU001979,558,173,385,84,840,2025-07-27
FC_WA02,SKU000880,559,161,398,84,840,2025-07-25
FC_WA02,SKU000402,1577,479,1098,210,2100,2025-07-21
FC_WA02,SKU000321,1551,449,1102,210,2100,2025-07-24
FC_WA02,SKU001576,807,238,569,140,1400,2025-07-24
FC_WA02,SKU000456,250,67,183,56,560,2025-07-22
FC_WA02,SKU001794,589,188,401,112,1120,2025-07-27
FC_WA02,SKU001232,1560,452,1108,210,2100,2025-07-25
FC_WA02,SKU001491,246,62,184,56,560,2025-07-22
FC_WA02,SKU000065,515,152,363,84,840,2025-07-24
FC_WA02,SKU000034,620,187,433,112,1120,2025-07-26
FC_WA02,SKU001126,517,157,360,84,840,2025-07-25
FC_WA02,SKU001423,841,222,619,140,1400,2025-07-26
FC_WA02,SKU000921,539,151,388,84,840,2025-07-22
FC_WA02,SKU001849,258,77,181,56,560,2025-07-26
FC_WA02,SKU001599,661,202,459,112,1120,2025-07-21
FC_WA02,SKU000012,810,232,578,140,1400,2025-07-23
FC_WA02,SKU001355,246,85,161,56,560,2025-07-27
FC_WA02,SKU001872,273,94,179,56,560,2025-07-24
FC_WA02,SKU001444,239,79,160,56,560,2025-07-24
FC_WA02,SKU000494,546,155,391,84,840,2025-07-22
FC_WA02,SKU000208,206,66,140,56,560,2025-07-25
FC_WA02,SKU001632,524,172,352,84,840,2025-07-21
FC_WA02,SKU000072,631,191,440,112,1120,2025-07-26
FC_WA02,SKU001920,861,270,591,140,1400,2025-07-27
FC_WA02,SKU000127,592,177,415,112,1120,2025-07-23
FC_WA02,SKU000060,544,153,391,84,840,2025-07-22
FC_WA02,SKU000352,528,182,346,84,840,2025-07-27
FC_WA02,SKU001983,1556,440,1116,210,2100,2025-07-26
FC_WA02,SKU000261,582,160,422,112,1120,2025-07-27
FC_WA02,SKU000879,527,167,360,84,840,2025-07-24
FC_WA02,SKU000808,1552,446,1106,210,2100,2025-07-25
FC_WA02,SKU001805,816,260,556,140,1400,2025-07-21
FC_WA02,SKU000736,548,171,377,84,840,2025-07-24
FC_WA02,SKU001944,1586,440,1146,210,2100,2025-07-22
FC_WA02,SKU001521,555,157,398,84,840,2025-07-21
FC_WA02,SKU000412,651,188,463,112,1120,2025-07-27
FC_WA02,SKU000269,267,77,190,56,560,2025-07-25
FC_WA02,SKU001074,245,80,165,56,560,2025-07-25
FC_WA02,SKU001135,835,246,589,140,1400,2025-07-21
FC_WA02,SKU001762,263,79,184,56,560,2025-07-25
FC_WA02,SKU001300,631,205,426,112,1120,2025-07-23
FC_WA02,SKU001785,1563,495,1068,210,2100,2025-07-23
FC_WA02,SKU001284,832,262,570,140,1400,2025-07-22
FC_WA02,SKU001458,246,68,178,56,560,2025-07-25
FC_WA02,SKU001484,566,191,375,84,840,2025-07-26
FC_WA02,SKU000451,256,70,186,56,560,2025-07-27
FC_WA02,SKU001991,611,198,413,112,1120,2025-07-21
FC_WA02,SKU001492,247,70,177,56,560,2025-07-27
FC_WA02,SKU001648,264,91,173,56,560,2025-07-27
FC_WA02,SKU000884,647,173,474,112,1120,2025-07-25
FC_WA02,SKU000540,858,256,602,140,1400,2025-07-21
FC_WA02,SKU001337,629,194,435,112,1120,2025-07-26
FC_WA02,SKU000186,594,195,399,112,1120,2025-07-27
FC_WA02,SKU001397,541,177,364,84,840,2025-07-21
FC_WA02,SKU000556,647,199,448,112,1120,2025-07-23
FC_WA02,SKU001878,228,60,168,56,560,2025-07-21
FC_WA02,SKU000431,842,240,602,140,1400,2025-07-23
FC_WA02,SKU000368,619,188,431,112,1120,2025-07-24
FC_WA02,SKU001871,847,261,586,140,1400,2025-07-26
FC_WA02,SKU001015,212,55,157,56,560,2025-07-21
FC_WA02,SKU000421,268,81,187,56,560,2025-07-21
FC_WA02,SKU000043,1544,463,1081,210,2100,2025-07-23
FC_WA02,SKU000465,849,247,602,140,1400,2025-07-21
FC_WA02,SKU001319,258,68,190,56,560,2025-07-22
FC_WA02,SKU001009,1509,482,1027,210,2100,2025-07-26
FC_WA02,SKU000988,563,154,409,84,840,2025-07-23
FC_WA02,SKU000223,259,69,190,56,560,2025-07-21
FC_WA02,SKU001182,853,266,587,140,1400,2025-07-22
FC_WA02,SKU000932,549,179,370,84,840,2025-07-23
FC_WA02,SKU000282,613,189,424,112,1120,2025-07-27
FC_WA02,SKU001251,290,87,203,56,560,2025-07-25
FC_WA02,SKU000630,1557,470,1087,210,2100,2025-07-27
FC_WA02,SKU001562,585,178,407,112,1120,2025-07-25
FC_WA02,SKU000193,651,172,479,112,1120,2025-07-22
FC_WA02,SKU000114,218,67,151,56,560,2025-07-22
FC_WA02,SKU001557,604,190,414,112,1120,2025-07-22
FC_WA02,SKU000376,1546,460,1086,210,2100,2025-07-21
FC_WA02,SKU001561,1633,554,1079,210,2100,2025-07-26
FC_WA02,SKU000627,555,177,378,84,840,2025-07-22
FC_WA02,SKU001885,602,153,449,112,1120,2025-07-22
FC_WA02,SKU000823,885,272,613,140,1400,2025-07-23
FC_WA02,SKU000819,815,251,564,140,1400,2025-07-21
FC_WA02,SKU000977,245,64,181,56,560,2025-07-23
FC_WA02,SKU000652,844,263,581,140,1400,2025-07-23
FC_WA02,SKU000841,244,81,163,56,560,2025-07-25
FC_WA02,SKU000071,1591,520,1071,210,2100,2025-07-27
FC_WA02,SKU001446,264,78,186,56,560,2025-07-22
FC_WA02,SKU001664,236,67,169,56,560,2025-07-23
FC_WA02,SKU001012,240,86,154,56,560,2025-07-23
FC_WA02,SKU000419,664,184,480,112,1120,2025-07-27
FC_WA02,SKU000888,903,276,627,140,1400,2025-07-27
FC_WA02,SKU000298,602,181,421,112,1120,2025-07-25
FC_WA02,SKU001959,879,257,622,140,1400,2025-07-21
FC_WA02,SKU000306,785,234,551,140,1400,2025-07-22
FC_WA02,SKU000692,598,165,433,112,1120,2025-07-22
FC_WA02,SKU001716,849,240,609,140,1400,2025-07-23
FC_WA02,SKU001817,519,167,352,84,840,2025-07-27
FC_WA02,SKU001223,582,153,429,112,1120,2025-07-26
FC_WA02,SKU000317,621,187,434,112,1120,2025-07-23
FC_WA02,SKU001876,522,159,363,84,840,2025-07-27
FC_WA02,SKU001860,253,97,156,56,560,2025-07-26
FC_WA02,SKU001892,260,83,177,56,560,2025-07-22
FC_WA02,SKU000093,817,285,532,140,1400,2025-07-26
FC_WA02,SKU001802,516,177,339,84,840,2025-07-27
FC_WA02,SKU001139,1632,529,1103,210,2100,2025-07-26
FC_WA02,SKU000395,876,260,616,140,1400,2025-07-25
FC_WA02,SKU001164,1605,463,1142,210,2100,2025-07-26
FC_WA02,SKU000963,854,255,599,140,1400,2025-07-27
FC_WA02,SKU000454,536,171,365,84,840,2025-07-22
FC_WA02,SKU001753,242,72,170,56,560,2025-07-23
FC_WA02,SKU000683,511,140,371,84,840,2025-07-25
FC_WA02,SKU001377,1589,476,1113,210,2100,2025-07-21
FC_WA02,SKU000147,258,78,180,56,560,2025-07-27
FC_WA02,SKU001239,533,148,385,84,840,2025-07-24
FC_WA02,SKU000778,525,150,375,84,840,2025-07-23
FC_WA02,SKU001986,1622,461,1161,210,2100,2025-07-22
FC_WA02,SKU001364,489,161,328,84,840,2025-07-25
FC_WA02,SKU001777,547,166,381,84,840,2025-07-25
FC_WA02,SKU001634,1551,455,1096,210,2100,2025-07-24
FC_WA02,SKU001921,243,55,188,56,560,2025-07-22
FC_WA02,SKU001768,267,82,185,56,560,2025-07-24
FC_WA02,SKU001008,538,148,390,84,840,2025-07-24
FC_WA02,SKU000811,525,161,364,84,840,2025-07-24
FC_WA02,SKU000724,523,144,379,84,840,2025-07-27
FC_WA02,SKU000470,555,140,415,84,840,2025-07-25
FC_WA02,SKU000440,853,265,588,140,1400,2025-07-25
FC_WA02,SKU000572,861,255,606,140,1400,2025-07-26
FC_WA02,SKU000365,1540,467,1073,210,2100,2025-07-24
FC_WA02,SKU000315,607,176,431,112,1120,2025-07-23
FC_WA02,SKU001829,1563,457,1106,210,2100,2025-07-21
FC_WA02,SKU000748,626,189,437,112,1120,2025-07-25
FC_WA02,SKU001125,620,203,417,112,1120,2025-07-22
FC_WA02,SKU001117,660,190,470,112,1120,2025-07-21
FC_WA02,SKU001071,303,83,220,56,560,2025-07-25
FC_WA02,SKU001118,561,162,399,84,840,2025-07-27
FC_WA02,SKU001496,274,78,196,56,560,2025-07-21
FC_WA02,SKU001569,628,158,470,112,1120,2025-07-24
FC_WA02,SKU000199,620,206,414,112,1120,2025-07-27
FC_WA02,SKU000506,605,175,430,112,1120,2025-07-24
FC_WA02,SKU000733,523,165,358,84,840,2025-07-27
FC_WA02,SKU000643,834,258,576,140,1400,2025-07-22
FC_WA02,SKU001714,619,181,438,112,1120,2025-07-27
FC_WA02,SKU000523,600,195,405,112,1120,2025-07-26
FC_WA02,SKU000818,613,187,426,112,1120,2025-07-22
FC_WA02,SKU001295,1587,484,1103,210,2100,2025-07-21
FC_WA02,SKU001374,581,148,433,84,840,2025-07-23
FC_WA02,SKU000171,1615,477,1138,210,2100,2025-07-27
FC_WA02,SKU001230,636,188,448,112,1120,2025-07-21
FC_WA02,SKU000113,560,155,405,84,840,2025-07-21
FC_WA02,SKU001387,802,248,554,140,1400,2025-07-23
FC_WA02,SKU001859,501,158,343,84,840,2025-07-21
FC_WA02,SKU001277,818,218,600,140,1400,2025-07-21
FC_WA02,SKU001587,248,61,187,56,560,2025-07-27
FC_WA02,SKU001407,867,243,624,140,1400,2025-07-24
FC_WA02,SKU000292,559,170,389,84,840,2025-07-23
FC_WA02,SKU000629,1533,430,1103,210,2100,2025-07-23
FC_WA02,SKU001776,823,232,591,140,1400,2025-07-22
FC_WA02,SKU000730,552,156,396,84,840,2025-07-24
FC_WA02,SKU001293,252,66,186,56,560,2025-07-22
FC_WA02,SKU000622,1611,486,1125,210,2100,2025-07-27
FC_WA02,SKU000956,877,243,634,140,1400,2025-07-22
FC_WA02,SKU001555,835,237,598,140,1400,2025-07-21
FC_WA02,SKU000538,846,259,587,140,1400,2025-07-26
FC_WA02,SKU000215,830,266,564,140,1400,2025-07-25
FC_WA02,SKU001843,590,163,427,112,1120,2025-07-24
FC_WA02,SKU000986,1580,484,1096,210,2100,2025-07-23
FC_WA02,SKU000237,1592,473,1119,210,2100,2025-07-21
FC_WA02,SKU001721,810,242,568,140,1400,2025-07-25
FC_WA02,SKU001302,648,182,466,112,1120,2025-07-21
FC_WA02,SKU001050,622,187,435,112,1120,2025-07-26
FC_WA02,SKU000681,1566,503,1063,210,2100,2025-07-24
FC_WA02,SKU000145,1559,466,1093,210,2100,2025-07-27
FC_WA02,SKU001383,247,85,162,56,560,2025-07-25
FC_WA02,SKU001628,568,166,402,112,1120,2025-07-21
FC_WA02,SKU001604,245,84,161,56,560,2025-07-24
FC_WA02,SKU000913,1694,479,1215,210,2100,2025-07-24
FC_WA02,SKU000140,238,71,167,56,560,2025-07-23
FC_WA02,SKU000243,603,176,427,112,1120,2025-07-23
FC_WA02,SKU000653,272,88,184,56,560,2025-07-26
FC_WA02,SKU000542,657,212,445,112,1120,2025-07-22
FC_WA02,SKU001779,1600,484,1116,210,2100,2025-07-23
FC_WA02,SKU000131,237,72,165,56,560,2025-07-27
FC_WA02,SKU001485,601,170,431,112,1120,2025-07-27
FC_WA02,SKU001427,526,186,340,84,840,2025-07-21
FC_WA02,SKU000723,624,177,447,112,1120,2025-07-22
FC_WA02,SKU000224,281,78,203,56,560,2025-07-27
FC_WA02,SKU001962,551,152,399,84,840,2025-07-24
FC_WA02,SKU000143,577,164,413,112,1120,2025-07-24
FC_WA02,SKU001348,870,261,609,140,1400,2025-07-22
FC_WA02,SKU000960,578,196,382,84,840,2025-07-25
FC_WA02,SKU001212,849,256,593,140,1400,2025-07-22
FC_WA02,SKU000890,846,266,580,140,1400,2025-07-25
FC_WA02,SKU000760,882,273,609,140,1400,2025-07-23
FC_WA02,SKU001093,224,74,150,56,560,2025-07-25
FC_WA02,SKU001433,255,86,169,56,560,2025-07-23
FC_WA02,SKU001002,875,281,594,140,1400,2025-07-24
FC_WA02,SKU000665,555,170,385,84,840,2025-07-21
FC_WA02,SKU001814,830,234,596,140,1400,2025-07-27
FC_WA02,SKU000400,1592,453,1139,210,2100,2025-07-27
FC_WA02,SKU000051,577,172,405,112,1120,2025-07-25
FC_WA02,SKU001588,591,189,402,84,840,2025-07-22
FC_WA02,SKU000133,529,168,361,84,840,2025-07-26
FC_WA02,SKU001908,1563,455,1108,210,2100,2025-07-23
FC_WA02,SKU000401,794,255,539,140,1400,2025-07-22
FC_WA02,SKU001363,265,62,203,56,560,2025-07-23
FC_WA02,SKU001480,601,166,435,112,1120,2025-07-27
FC_WA02,SKU001974,581,175,406,84,840,2025-07-22
FC_WA02,SKU001120,264,74,190,56,560,2025-07-23
FC_WA02,SKU001163,591,194,397,112,1120,2025-07-26
FC_WA02,SKU001581,841,244,597,140,1400,2025-07-21
FC_WA02,SKU001858,1477,430,1047,210,2100,2025-07-24
FC_WA02,SKU001985,527,152,375,84,840,2025-07-26
FC_WA02,SKU001960,629,198,431,112,1120,2025-07-24
FC_WA02,SKU000019,1566,498,1068,210,2100,2025-07-21
FC_WA02,SKU000129,636,208,428,112,1120,2025-07-21
FC_WA02,SKU001813,882,264,618,140,1400,2025-07-23
FC_WA02,SKU000079,644,183,461,112,1120,2025-07-26
FC_WA02,SKU000123,851,265,586,140,1400,2025-07-25
FC_WA02,SKU001545,546,154,392,84,840,2025-07-22
FC_WA02,SKU001558,843,281,562,140,1400,2025-07-23
FC_WA02,SKU001824,626,176,450,112,1120,2025-07-26
FC_WA02,SKU001519,537,157,380,84,840,2025-07-25
FC_WA02,SKU000744,865,234,631,140,1400,2025-07-24
FC_WA02,SKU000539,629,177,452,112,1120,2025-07-22
FC_WA02,SKU001917,1579,500,1079,210,2100,2025-07-24
FC_WA02,SKU000517,800,224,576,140,1400,2025-07-22
FC_WA02,SKU001096,822,238,584,140,1400,2025-07-25
FC_WA02,SKU000658,1626,464,1162,210,2100,2025-07-27
FC_WA02,SKU000671,1515,482,1033,210,2100,2025-07-23
FC_WA02,SKU000248,1560,454,1106,210,2100,2025-07-27
FC_WA02,SKU001640,619,174,445,112,1120,2025-07-25
FC_WA02,SKU000326,284,80,204,56,560,2025-07-22
FC_WA02,SKU001924,846,271,575,140,1400,2025-07-26
FC_WA02,SKU001687,235,79,156,56,560,2025-07-23
FC_WA02,SKU001637,603,185,418,112,1120,2025-07-24
FC_WA02,SKU000691,546,168,378,84,840,2025-07-26
FC_WA02,SKU001529,603,169,434,112,1120,2025-07-27
FC_WA02,SKU000849,1557,473,1084,210,2100,2025-07-21
FC_WA02,SKU001650,873,265,608,140,1400,2025-07-22
FC_WA02,SKU001834,262,73,189,56,560,2025-07-25
FC_WA02,SKU001823,247,58,189,56,560,2025-07-24
FC_WA02,SKU000362,587,162,425,112,1120,2025-07-24
FC_WA02,SKU000544,610,216,394,112,1120,2025-07-26
FC_WA02,SKU001100,599,167,432,112,1120,2025-07-25
FC_WA02,SKU001791,905,258,647,140,1400,2025-07-27
FC_WA02,SKU001840,529,166,363,84,840,2025-07-24
FC_WA02,SKU001666,1584,474,1110,210,2100,2025-07-26
FC_WA02,SKU000118,854,250,604,140,1400,2025-07-22
FC_WA02,SKU000609,554,179,375,112,1120,2025-07-23
FC_WA02,SKU000169,625,199,426,112,1120,2025-07-23
FC_WA02,SKU000922,274,92,182,56,560,2025-07-21
FC_WA02,SKU000816,648,179,469,112,1120,2025-07-22
FC_WA02,SKU000980,240,66,174,56,560,2025-07-21
FC_WA02,SKU001265,827,218,609,140,1400,2025-07-23
FC_WA02,SKU000935,1629,458,1171,210,2100,2025-07-22
FC_WA02,SKU000241,1598,442,1156,210,2100,2025-07-25
FC_WA02,SKU000897,263,78,185,56,560,2025-07-27
FC_WA02,SKU000936,1530,489,1041,210,2100,2025-07-25
FC_WA02,SKU000746,846,278,568,140,1400,2025-07-22
FC_WA02,SKU001515,1530,509,1021,210,2100,2025-07-22
FC_WA02,SKU000875,249,76,173,56,560,2025-07-27
FC_WA02,SKU001696,247,75,172,56,560,2025-07-25
FC_WA02,SKU001999,243,76,167,56,560,2025-07-27
FC_WA02,SKU001756,259,86,173,56,560,2025-07-21
FC_WA02,SKU001229,268,77,191,56,560,2025-07-22
FC_WA02,SKU001411,1647,466,1181,210,2100,2025-07-21
FC_WA02,SKU001106,1561,508,1053,210,2100,2025-07-22
FC_WA02,SKU000162,1538,461,1077,210,2100,2025-07-24
FC_WA02,SKU000322,813,274,539,140,1400,2025-07-25
FC_WA02,SKU001176,1599,477,1122,210,2100,2025-07-21
FC_WA02,SKU001286,538,172,366,84,840,2025-07-22
FC_WA02,SKU000411,880,238,642,140,1400,2025-07-23
FC_WA02,SKU001833,626,192,434,112,1120,2025-07-25
FC_WA02,SKU001328,619,200,419,112,1120,2025-07-24
FC_WA02,SKU001381,604,209,395,112,1120,2025-07-25
FC_WA02,SKU000721,632,209,423,112,1120,2025-07-25
FC_WA02,SKU001420,554,152,402,84,840,2025-07-27
FC_WA02,SKU000945,565,157,408,112,1120,2025-07-22
FC_WA02,SKU001560,1535,447,1088,210,2100,2025-07-27
FC_WA02,SKU001748,571,194,377,84,840,2025-07-21
FC_WA02,SKU001726,1566,482,1084,210,2100,2025-07-22
FC_WA02,SKU000851,560,154,406,84,840,2025-07-24
FC_WA02,SKU000920,256,68,188,56,560,2025-07-21
FC_WA02,SKU001254,1542,469,1073,210,2100,2025-07-27
FC_WA02,SKU000771,1534,483,1051,210,2100,2025-07-22
FC_WA02,SKU001445,609,180,429,112,1120,2025-07-22
FC_WA02,SKU000535,256,75,181,56,560,2025-07-23
FC_WA02,SKU001243,539,151,388,84,840,2025-07-25
FC_WA02,SKU001014,287,89,198,56,560,2025-07-26
FC_WA02,SKU001018,578,179,399,84,840,2025-07-23
FC_WA02,SKU001682,862,260,602,140,1400,2025-07-21
FC_WA02,SKU001997,570,155,415,84,840,2025-07-25
FC_WA02,SKU000713,845,248,597,140,1400,2025-07-27
FC_WA02,SKU001288,592,152,440,84,840,2025-07-25
FC_WA02,SKU001733,602,188,414,112,1120,2025-07-25
FC_WA02,SKU001649,631,199,432,112,1120,2025-07-21
FC_WA02,SKU001663,571,178,393,84,840,2025-07-22
FC_WA02,SKU001350,555,175,380,84,840,2025-07-26
FC_WA02,SKU000987,1556,494,1062,210,2100,2025-07-22
FC_WA02,SKU001371,525,181,344,84,840,2025-07-25
FC_WA02,SKU001000,1613,520,1093,210,2100,2025-07-27
FC_WA02,SKU000028,1629,465,1164,210,2100,2025-07-23
FC_WA02,SKU001244,1561,467,1094,210,2100,2025-07-26
FC_WA02,SKU000901,614,186,428,112,1120,2025-07-27
FC_WA02,SKU000482,1589,506,1083,210,2100,2025-07-27
FC_WA02,SKU001799,1520,477,1043,210,2100,2025-07-27
FC_WA02,SKU000598,570,178,392,84,840,2025-07-24
FC_WA02,SKU001978,790,252,538,140,1400,2025-07-26
FC_WA02,SKU000534,547,147,400,84,840,2025-07-27
FC_WA02,SKU000522,525,160,365,84,840,2025-07-26
FC_WA02,SKU000041,600,167,433,112,1120,2025-07-22
FC_WA02,SKU001020,235,67,168,56,560,2025-07-27
FC_WA02,SKU000035,831,244,587,140,1400,2025-07-21
FC_WA02,SKU000231,828,250,578,140,1400,2025-07-23
FC_WA02,SKU001913,549,134,415,84,840,2025-07-27
FC_WA02,SKU000942,600,162,438,112,1120,2025-07-23
FC_WA02,SKU001069,838,244,594,140,1400,2025-07-24
FC_WA02,SKU000340,620,197,423,112,1120,2025-07-27
FC_WA02,SKU001248,654,166,488,112,1120,2025-07-26
FC_WA02,SKU000616,1531,474,1057,210,2100,2025-07-21
FC_WA02,SKU001537,861,263,598,140,1400,2025-07-25
FC_WA02,SKU000309,585,173,412,84,840,2025-07-22
FC_WA02,SKU001624,1558,481,1077,210,2100,2025-07-21
FC_WA02,SKU001564,613,203,410,112,1120,2025-07-24
FC_WA02,SKU001669,573,165,408,84,840,2025-07-26
FC_WA02,SKU001499,1576,481,1095,210,2100,2025-07-23
FC_WA02,SKU001245,586,186,400,112,1120,2025-07-21
FC_WA02,SKU001035,820,233,587,140,1400,2025-07-27
FC_WA02,SKU001765,788,263,525,140,1400,2025-07-21
FC_WA02,SKU001315,826,213,613,140,1400,2025-07-23
FC_WA02,SKU001848,810,226,584,140,1400,2025-07-27
FC_WA02,SKU000772,258,75,183,56,560,2025-07-22
FC_WA02,SKU000095,588,163,425,84,840,2025-07-22
FC_WA02,SKU001175,850,277,573,140,1400,2025-07-23
FC_WA02,SKU001044,570,154,416,84,840,2025-07-22
FC_WA02,SKU001851,582,182,400,84,840,2025-07-21
FC_WA02,SKU001972,280,78,202,56,560,2025-07-24
FC_WA02,SKU000441,253,67,186,56,560,2025-07-27
FC_WA02,SKU001964,831,257,574,140,1400,2025-07-23
FC_WA02,SKU000059,516,135,381,84,840,2025-07-24
FC_WA02,SKU000236,914,298,616,140,1400,2025-07-22
FC_WA02,SKU001905,1577,498,1079,210,2100,2025-07-24
FC_WA02,SKU001930,557,148,409,84,840,2025-07-23
FC_WA02,SKU000657,611,186,425,112,1120,2025-07-21
FC_WA02,SKU001535,880,283,597,140,1400,2025-07-24
FC_WA02,SKU001652,253,69,184,56,560,2025-07-24
FC_WA02,SKU001426,612,185,427,112,1120,2025-07-24
FC_WA02,SKU001408,1516,466,1050,210,2100,2025-07-25
FC_WA02,SKU000690,620,195,425,112,1120,2025-07-27
FC_WA02,SKU001665,536,178,358,84,840,2025-07-26
FC_WA02,SKU000900,233,70,163,56,560,2025-07-27
FC_WA02,SKU001612,555,159,396,84,840,2025-07-24
FC_WA02,SKU001898,494,158,336,84,840,2025-07-22
FC_WA02,SKU000379,606,175,431,112,1120,2025-07-24
FC_WA02,SKU000787,243,58,185,56,560,2025-07-27
FC_WA02,SKU001654,220,77,143,56,560,2025-07-26
FC_WA02,SKU001483,1599,502,1097,210,2100,2025-07-23
FC_WA02,SKU001674,868,254,614,140,1400,2025-07-24
FC_WA02,SKU001211,614,197,417,112,1120,2025-07-21
FC_WA02,SKU000268,240,69,171,56,560,2025-07-21
FC_WA02,SKU000782,874,264,610,140,1400,2025-07-22
FC_WA02,SKU000146,1579,497,1082,210,2100,2025-07-26
FC_WA02,SKU000684,878,286,592,140,1400,2025-07-26
FC_WA02,SKU000763,893,270,623,140,1400,2025-07-27
FC_WA02,SKU000614,613,170,443,112,1120,2025-07-23
FC_WA02,SKU001247,802,245,557,140,1400,2025-07-23
FC_WA02,SKU001084,544,161,383,84,840,2025-07-24
FC_WA02,SKU001766,613,190,423,84,840,2025-07-25
FC_WA02,SKU001431,570,171,399,84,840,2025-07-21
FC_WA02,SKU000150,843,253,590,140,1400,2025-07-21
FC_WA02,SKU000737,1564,429,1135,210,2100,2025-07-24
FC_WA02,SKU000066,259,81,178,56,560,2025-07-22
FC_WA02,SKU001796,621,178,443,112,1120,2025-07-25
FC_WA02,SKU000774,1507,430,1077,210,2100,2025-07-22
FC_WA02,SKU000589,595,168,427,112,1120,2025-07-22
FC_WA02,SKU001416,1521,476,1045,210,2100,2025-07-23
FC_WA02,SKU000408,605,194,411,112,1120,2025-07-21
FC_WA02,SKU001866,1541,469,1072,210,2100,2025-07-23
FC_WA02,SKU000558,538,187,351,84,840,2025-07-21
FC_WA02,SKU000624,788,238,550,140,1400,2025-07-26
FC_WA02,SKU000664,856,224,632,140,1400,2025-07-25
FC_WA02,SKU001906,541,176,365,84,840,2025-07-25
FC_WA02,SKU001984,498,178,320,84,840,2025-07-21
FC_WA02,SKU000636,850,260,590,140,1400,2025-07-26
FC_WA02,SKU000984,638,181,457,112,1120,2025-07-21
FC_WA02,SKU001097,209,55,154,56,560,2025-07-25
FC_WA02,SKU001299,615,164,451,112,1120,2025-07-22
FC_WA02,SKU000952,582,178,404,84,840,2025-07-25
FC_WA02,SKU001088,538,168,370,84,840,2025-07-25
FC_WA02,SKU001242,784,248,536,140,1400,2025-07-27
FC_WA02,SKU001306,585,158,427,112,1120,2025-07-24
FC_WA02,SKU000153,664,208,456,112,1120,2025-07-26
FC_WA02,SKU000504,562,158,404,84,840,2025-07-24
FC_WA02,SKU000965,1635,458,1177,210,2100,2025-07-27
FC_WA02,SKU001258,609,172,437,112,1120,2025-07-22
FC_WA02,SKU001615,1528,454,1074,210,2100,2025-07-21
FC_WA02,SKU001316,1624,511,1113,210,2100,2025-07-27
FC_WA02,SKU001856,239,58,181,56,560,2025-07-26
FC_WA02,SKU001405,902,252,650,140,1400,2025-07-22
FC_WA02,SKU000057,554,171,383,84,840,2025-07-27
FC_WA02,SKU001455,639,193,446,112,1120,2025-07-24
FC_WA02,SKU000110,844,250,594,140,1400,2025-07-27
FC_WA02,SKU000976,589,181,408,112,1120,2025-07-21
FC_WA02,SKU001850,223,76,147,56,560,2025-07-27
FC_WA02,SKU000840,876,262,614,140,1400,2025-07-22
FC_WA02,SKU000040,246,80,166,56,560,2025-07-27
FC_WA02,SKU000075,1618,497,1121,210,2100,2025-07-25
FC_WA02,SKU000896,832,236,596,140,1400,2025-07-27
FC_WA02,SKU000996,868,248,620,140,1400,2025-07-25
FC_WA02,SKU001854,272,78,194,56,560,2025-07-22
FC_WA02,SKU001079,251,76,175,56,560,2025-07-23
FC_WA02,SKU001897,248,80,168,56,560,2025-07-24
FC_WA02,SKU001506,601,163,438,112,1120,2025-07-24
FC_WA02,SKU001255,799,253,546,140,1400,2025-07-24
FC_WA02,SKU001729,294,101,193,56,560,2025-07-21
FC_WA02,SKU000389,594,179,415,112,1120,2025-07-24
FC_WA02,SKU001808,650,213,437,112,1120,2025-07-25
FC_WA02,SKU001361,837,259,578,140,1400,2025-07-26
FC_WA02,SKU000142,210,47,163,56,560,2025-07-22
FC_WA02,SKU001904,894,273,621,140,1400,2025-07-24
FC_WA02,SKU001200,612,163,449,112,1120,2025-07-27
FC_WA02,SKU001024,557,172,385,84,840,2025-07-26
FC_WA02,SKU001213,1535,434,1101,210,2100,2025-07-23
FC_WA02,SKU001313,1547,453,1094,210,2100,2025-07-22
FC_WA02,SKU000676,1510,466,1044,210,2100,2025-07-23
FC_WA02,SKU000886,240,63,177,56,560,2025-07-27
FC_WA02,SKU001524,1620,483,1137,210,2100,2025-07-25
FC_WA02,SKU000077,1585,488,1097,210,2100,2025-07-23
FC_WA02,SKU000316,817,248,569,140,1400,2025-07-25
FC_WA02,SKU001818,1529,469,1060,210,2100,2025-07-22
FC_WA02,SKU000604,1502,463,1039,210,2100,2025-07-21
FC_WA02,SKU000634,1614,467,1147,210,2100,2025-07-21
FC_WA02,SKU001325,647,194,453,112,1120,2025-07-25
FC_WA02,SKU000576,588,146,442,112,1120,2025-07-21
FC_WA02,SKU001877,806,240,566,140,1400,2025-07-24
FC_WA02,SKU001298,277,81,196,56,560,2025-07-24
FC_WA02,SKU001845,527,158,369,84,840,2025-07-22
FC_WA02,SKU000780,605,176,429,112,1120,2025-07-26
FC_WA02,SKU001338,1468,452,1016,210,2100,2025-07-22
FC_WA02,SKU000068,1611,452,1159,210,2100,2025-07-23
FC_WA02,SKU000449,255,78,177,56,560,2025-07-21
FC_WA02,SKU001865,801,252,549,140,1400,2025-07-21
FC_WA02,SKU001585,1537,493,1044,210,2100,2025-07-21
FC_WA02,SKU000047,1584,450,1134,210,2100,2025-07-26
FC_WA02,SKU001633,580,177,403,84,840,2025-07-21
FC_WA02,SKU001511,241,70,171,56,560,2025-07-25
FC_WA02,SKU000821,530,150,380,84,840,2025-07-26
FC_WA02,SKU001335,877,260,617,140,1400,2025-07-27
FC_WA02,SKU000263,797,236,561,140,1400,2025-07-25
FC_WA02,SKU000240,259,94,165,56,560,2025-07-23
FC_WA02,SKU001893,853,258,595,140,1400,2025-07-26
FC_WA02,SKU001501,1608,474,1134,210,2100,2025-07-22
FC_WA02,SKU001879,842,275,567,140,1400,2025-07-22
FC_WA02,SKU000183,610,194,416,112,1120,2025-07-27
FC_WA02,SKU001909,1537,463,1074,210,2100,2025-07-25
FC_WA02,SKU001760,1531,476,1055,210,2100,2025-07-27
FC_WA02,SKU000165,262,78,184,56,560,2025-07-27
FC_WA02,SKU001622,632,175,457,112,1120,2025-07-23
FC_WA02,SKU001582,893,257,636,140,1400,2025-07-25
FC_WA02,SKU001642,778,221,557,140,1400,2025-07-27
FC_WA02,SKU000130,268,88,180,56,560,2025-07-24
FC_WA02,SKU001717,258,84,174,56,560,2025-07-21
FC_WA02,SKU000856,848,272,576,140,1400,2025-07-24
FC_WA02,SKU000273,255,78,177,56,560,2025-07-26
FC_WA02,SKU000203,542,159,383,84,840,2025-07-21
FC_WA02,SKU001976,253,74,179,56,560,2025-07-25
FC_WA02,SKU001442,818,227,591,140,1400,2025-07-26
FC_WA02,SKU000648,1567,472,1095,210,2100,2025-07-22
FC_WA02,SKU001235,1537,450,1087,210,2100,2025-07-22
FC_WA02,SKU001966,603,201,402,112,1120,2025-07-26
FC_WA02,SKU001449,1595,511,1084,210,2100,2025-07-24
FC_WA02,SKU001790,253,65,188,56,560,2025-07-25
FC_WA02,SKU001376,620,178,442,112,1120,2025-07-25
FC_WA02,SKU000635,540,179,361,84,840,2025-07-25
FC_WA02,SKU001058,259,74,185,56,560,2025-07-24
FC_WA02,SKU000433,241,69,172,56,560,2025-07-22
FC_WA02,SKU001651,558,159,399,84,840,2025-07-26
FC_WA02,SKU000803,603,192,411,112,1120,2025-07-24
FC_WA02,SKU000769,597,169,428,112,1120,2025-07-25
FC_WA02,SKU001107,616,172,444,112,1120,2025-07-25
FC_WA02,SKU001899,1574,506,1068,210,2100,2025-07-26
FC_WA02,SKU001855,1633,489,1144,210,2100,2025-07-26
FC_WA02,SKU001417,1581,494,1087,210,2100,2025-07-22
FC_WA02,SKU001950,928,256,672,140,1400,2025-07-25
FC_WA02,SKU000859,599,189,410,112,1120,2025-07-26
FC_WA02,SKU000157,532,134,398,84,840,2025-07-22
FC_WA02,SKU001388,518,150,368,84,840,2025-07-22
FC_WA02,SKU000513,834,255,579,140,1400,2025-07-22
FC_WA02,SKU000866,668,197,471,112,1120,2025-07-22
FC_WA02,SKU001403,265,88,177,56,560,2025-07-21
FC_WA02,SKU001005,799,255,544,140,1400,2025-07-26
FC_WA02,SKU000747,1569,453,1116,210,2100,2025-07-21
FC_WA02,SKU001140,825,233,592,140,1400,2025-07-22
FC_WA02,SKU001048,258,81,177,56,560,2025-07-27
FC_WA02,SKU001065,1581,447,1134,210,2100,2025-07-21
FC_WA02,SKU001384,1565,452,1113,210,2100,2025-07-25
FC_WA02,SKU001789,241,76,165,56,560,2025-07-27
FC_WA02,SKU000161,512,140,372,84,840,2025-07-27
FC_WA02,SKU000776,852,225,627,140,1400,2025-07-23
FC_WA02,SKU001354,529,159,370,84,840,2025-07-25
FC_WA02,SKU001758,550,156,394,84,840,2025-07-27
FC_WA02,SKU000414,533,162,371,84,840,2025-07-26
FC_WA02,SKU000619,1586,469,1117,210,2100,2025-07-26
FC_WA02,SKU001811,246,67,179,56,560,2025-07-23
FC_WA02,SKU000943,551,180,371,84,840,2025-07-25
FC_WA02,SKU001567,582,178,404,112,1120,2025-07-23
FC_WA02,SKU001786,251,82,169,56,560,2025-07-25
FC_WA02,SKU000679,583,180,403,84,840,2025-07-25
FC_WA02,SKU000025,516,164,352,84,840,2025-07-22
FC_WA02,SKU000415,247,68,179,56,560,2025-07-25
FC_WA02,SKU001023,774,237,537,140,1400,2025-07-26
FC_WA02,SKU001289,583,197,386,112,1120,2025-07-26
FC_WA02,SKU001512,269,80,189,56,560,2025-07-21
FC_WA02,SKU001287,574,178,396,84,840,2025-07-25
FC_WA02,SKU000907,537,170,367,84,840,2025-07-21
FC_WA02,SKU000247,841,234,607,140,1400,2025-07-23
FC_TX03,SKU000567,566,172,394,84,840,2025-07-23
FC_TX03,SKU001627,822,233,589,140,1400,2025-07-25
FC_TX03,SKU001322,1585,472,1113,210,2100,2025-07-27
FC_TX03,SKU001710,627,161,466,112,1120,2025-07-24
FC_TX03,SKU000509,1541,526,1015,210,2100,2025-07-27
FC_TX03,SKU001494,552,138,414,112,1120,2025-07-21
FC_TX03,SKU001134,1579,474,1105,210,2100,2025-07-27
FC_TX03,SKU000957,630,193,437,112,1120,2025-07-26
FC_TX03,SKU001884,528,156,372,84,840,2025-07-21
FC_TX03,SKU000808,1629,523,1106,210,2100,2025-07-27
FC_TX03,SKU001545,518,144,374,84,840,2025-07-26
FC_TX03,SKU000751,588,164,424,112,1120,2025-07-27
FC_TX03,SKU001224,520,163,357,84,840,2025-07-23
FC_TX03,SKU000085,812,249,563,140,1400,2025-07-21
FC_TX03,SKU000921,558,155,403,84,840,2025-07-24
FC_TX03,SKU001492,251,95,156,56,560,2025-07-23
FC_TX03,SKU000865,1549,447,1102,210,2100,2025-07-24
FC_TX03,SKU001086,597,181,416,112,1120,2025-07-22
FC_TX03,SKU000267,591,194,397,112,1120,2025-07-22
FC_TX03,SKU001104,584,181,403,112,1120,2025-07-27
FC_TX03,SKU001164,1487,432,1055,210,2100,2025-07-27
FC_TX03,SKU000620,565,136,429,84,840,2025-07-25
FC_TX03,SKU001558,887,261,626,140,1400,2025-07-23
FC_TX03,SKU000746,804,240,564,140,1400,2025-07-22
FC_TX03,SKU000622,1550,425,1125,210,2100,2025-07-22
FC_TX03,SKU001855,1576,466,1110,210,2100,2025-07-21
FC_TX03,SKU000801,253,72,181,56,560,2025-07-21
FC_TX03,SKU001962,536,161,375,84,840,2025-07-23
FC_TX03,SKU001661,252,74,178,56,560,2025-07-23
FC_TX03,SKU000604,1517,404,1113,210,2100,2025-07-27
FC_TX03,SKU001148,1645,476,1169,210,2100,2025-07-27
FC_TX03,SKU000600,874,285,589,140,1400,2025-07-23
FC_TX03,SKU000430,815,227,588,140,1400,2025-07-21
FC_TX03,SKU000354,645,206,439,112,1120,2025-07-27
FC_TX03,SKU001036,1562,468,1094,210,2100,2025-07-21
FC_TX03,SKU001020,241,80,161,56,560,2025-07-24
FC_TX03,SKU001346,850,254,596,140,1400,2025-07-21
FC_TX03,SKU001227,1572,415,1157,210,2100,2025-07-21
FC_TX03,SKU000017,570,178,392,84,840,2025-07-24
FC_TX03,SKU000657,588,165,423,112,1120,2025-07-26
FC_TX03,SKU000715,503,176,327,84,840,2025-07-26
FC_TX03,SKU001758,550,161,389,84,840,2025-07-25
FC_TX03,SKU001043,277,80,197,56,560,2025-07-27
FC_TX03,SKU001128,1659,485,1174,210,2100,2025-07-24
FC_TX03,SKU001470,853,267,586,140,1400,2025-07-27
FC_TX03,SKU001042,606,178,428,112,1120,2025-07-21
FC_TX03,SKU001103,626,178,448,112,1120,2025-07-22
FC_TX03,SKU001233,590,180,410,112,1120,2025-07-24
FC_TX03,SKU000836,885,249,636,140,1400,2025-07-21
FC_TX03,SKU001649,635,210,425,112,1120,2025-07-25
FC_TX03,SKU000753,866,278,588,140,1400,2025-07-26
FC_TX03,SKU001223,593,174,419,112,1120,2025-07-25
FC_TX03,SKU001201,655,180,475,112,1120,2025-07-21
FC_TX03,SKU000030,611,194,417,112,1120,2025-07-22
FC_TX03,SKU001576,816,276,540,140,1400,2025-07-25
FC_TX03,SKU001440,1571,464,1107,210,2100,2025-07-26
FC_TX03,SKU001203,588,164,424,112,1120,2025-07-27
FC_TX03,SKU001349,236,73,163,56,560,2025-07-26
FC_TX03,SKU000140,247,70,177,56,560,2025-07-21
FC_TX03,SKU000925,280,88,192,56,560,2025-07-21
FC_TX03,SKU000066,258,83,175,56,560,2025-07-24
FC_TX03,SKU001348,882,275,607,140,1400,2025-07-21
FC_TX03,SKU001876,535,158,377,84,840,2025-07-22
FC_TX03,SKU000479,851,252,599,140,1400,2025-07-26
FC_TX03,SKU000719,597,187,410,112,1120,2025-07-27
FC_TX03,SKU001006,563,171,392,112,1120,2025-07-21
FC_TX03,SKU000681,1560,456,1104,210,2100,2025-07-24
FC_TX03,SKU001434,244,69,175,56,560,2025-07-25
FC_TX03,SKU000996,845,266,579,140,1400,2025-07-23
FC_TX03,SKU000477,504,146,358,84,840,2025-07-25
FC_TX03,SKU000299,581,188,393,112,1120,2025-07-21
FC_TX03,SKU000133,568,158,410,84,840,2025-07-27
FC_TX03,SKU001753,253,62,191,56,560,2025-07-22
FC_TX03,SKU001173,572,175,397,84,840,2025-07-27
FC_TX03,SKU000767,856,257,599,140,1400,2025-07-23
FC_TX03,SKU001932,768,262,506,140,1400,2025-07-27
FC_TX03,SKU001773,241,68,173,56,560,2025-07-26
FC_TX03,SKU000904,229,62,167,56,560,2025-07-24
FC_TX03,SKU000251,239,60,179,56,560,2025-07-27
FC_TX03,SKU001675,804,238,566,140,1400,2025-07-27
FC_TX03,SKU001433,250,69,181,56,560,2025-07-23
FC_TX03,SKU000607,547,182,365,84,840,2025-07-25
FC_TX03,SKU000350,843,267,576,140,1400,2025-07-22
FC_TX03,SKU001126,548,148,400,84,840,2025-07-25
FC_TX03,SKU001358,1601,481,1120,210,2100,2025-07-26
FC_TX03,SKU000706,249,74,175,56,560,2025-07-21
FC_TX03,SKU001891,244,57,187,56,560,2025-07-26
FC_TX03,SKU000359,849,277,572,140,1400,2025-07-23
FC_TX03,SKU000370,865,237,628,140,1400,2025-07-25
FC_TX03,SKU001848,792,235,557,140,1400,2025-07-26
FC_TX03,SKU000377,549,151,398,84,840,2025-07-26
FC_TX03,SKU000916,272,70,202,56,560,2025-07-21
FC_TX03,SKU000454,526,149,377,84,840,2025-07-26
FC_TX03,SKU001167,598,180,418,112,1120,2025-07-26
FC_TX03,SKU001350,502,140,362,84,840,2025-07-24
FC_TX03,SKU000499,634,208,426,112,1120,2025-07-23
FC_TX03,SKU000682,549,155,394,84,840,2025-07-25
FC_TX03,SKU001591,554,174,380,84,840,2025-07-27
FC_TX03,SKU000451,271,80,191,56,560,2025-07-24
FC_TX03,SKU001588,535,162,373,84,840,2025-07-23
FC_TX03,SKU001372,530,173,357,84,840,2025-07-25
FC_TX03,SKU000579,605,162,443,112,1120,2025-07-22
FC_TX03,SKU001447,839,238,601,140,1400,2025-07-25
FC_TX03,SKU000281,1642,527,1115,210,2100,2025-07-24
FC_TX03,SKU001858,1633,511,1122,210,2100,2025-07-27
FC_TX03,SKU000527,276,91,185,56,560,2025-07-26
FC_TX03,SKU000752,900,277,623,140,1400,2025-07-27
FC_TX03,SKU000240,263,75,188,56,560,2025-07-27
FC_TX03,SKU001040,540,175,365,84,840,2025-07-22
FC_TX03,SKU000728,886,258,628,140,1400,2025-07-24
FC_TX03,SKU001276,636,181,455,112,1120,2025-07-22
FC_TX03,SKU000823,877,272,605,140,1400,2025-07-22
FC_TX03,SKU000160,263,85,178,56,560,2025-07-24
FC_TX03,SKU001008,555,162,393,84,840,2025-07-24
FC_TX03,SKU001580,523,161,362,84,840,2025-07-22
FC_TX03,SKU000605,480,112,368,84,840,2025-07-26
FC_TX03,SKU001577,1553,488,1065,210,2100,2025-07-26
FC_TX03,SKU001011,908,266,642,140,1400,2025-07-21
FC_TX03,SKU001108,267,72,195,56,560,2025-07-25
FC_TX03,SKU001530,550,157,393,84,840,2025-07-21
FC_TX03,SKU001958,608,203,405,112,1120,2025-07-27
FC_TX03,SKU000856,843,266,577,140,1400,2025-07-26
FC_TX03,SKU001831,836,260,576,140,1400,2025-07-25
FC_TX03,SKU001159,536,154,382,84,840,2025-07-25
FC_TX03,SKU000408,588,199,389,112,1120,2025-07-21
FC_TX03,SKU000174,541,173,368,84,840,2025-07-24
FC_TX03,SKU001586,1603,486,1117,210,2100,2025-07-26
FC_TX03,SKU000022,848,273,575,140,1400,2025-07-22
FC_TX03,SKU001764,1529,458,1071,210,2100,2025-07-24
FC_TX03,SKU000616,1539,438,1101,210,2100,2025-07-24
FC_TX03,SKU001977,616,168,448,112,1120,2025-07-27
FC_TX03,SKU000270,255,81,174,56,560,2025-07-21
FC_TX03,SKU001093,257,73,184,56,560,2025-07-27
FC_TX03,SKU000867,561,171,390,84,840,2025-07-27
FC_TX03,SKU000318,571,168,403,84,840,2025-07-27
FC_TX03,SKU000231,831,248,583,140,1400,2025-07-25
FC_TX03,SKU001217,1584,503,1081,210,2100,2025-07-26
FC_TX03,SKU001072,1551,484,1067,210,2100,2025-07-27
FC_TX03,SKU000393,244,82,162,56,560,2025-07-25
FC_TX03,SKU001904,832,256,576,140,1400,2025-07-21
FC_TX03,SKU001920,833,251,582,140,1400,2025-07-22
FC_TX03,SKU001220,1473,471,1002,210,2100,2025-07-23
FC_TX03,SKU000119,1566,461,1105,210,2100,2025-07-27
FC_TX03,SKU001094,602,189,413,112,1120,2025-07-22
FC_TX03,SKU000582,878,233,645,140,1400,2025-07-23
FC_TX03,SKU000380,597,198,399,112,1120,2025-07-27
FC_TX03,SKU000617,264,72,192,56,560,2025-07-26
FC_TX03,SKU000874,546,147,399,84,840,2025-07-21
FC_TX03,SKU000510,1559,457,1102,210,2100,2025-07-26
FC_TX03,SKU000034,580,169,411,112,1120,2025-07-24
FC_TX03,SKU001998,844,262,582,140,1400,2025-07-21
FC_TX03,SKU001703,609,167,442,112,1120,2025-07-24
FC_TX03,SKU000190,1604,502,1102,210,2100,2025-07-23
FC_TX03,SKU000097,280,88,192,56,560,2025-07-21
FC_TX03,SKU000425,879,242,637,140,1400,2025-07-22
FC_TX03,SKU000211,827,243,584,140,1400,2025-07-23
FC_TX03,SKU000264,836,249,587,140,1400,2025-07-24
FC_TX03,SKU000517,847,274,573,140,1400,2025-07-27
FC_TX03,SKU000619,1560,436,1124,210,2100,2025-07-24
FC_TX03,SKU001501,1603,440,1163,210,2100,2025-07-23
FC_TX03,SKU000902,223,69,154,56,560,2025-07-27
FC_TX03,SKU001997,514,167,347,84,840,2025-07-23
FC_TX03,SKU000774,1631,485,1146,210,2100,2025-07-27
FC_TX03,SKU001024,560,168,392,84,840,2025-07-21
FC_TX03,SKU001458,260,70,190,56,560,2025-07-24
FC_TX03,SKU001677,265,87,178,56,560,2025-07-21
FC_TX03,SKU000886,254,82,172,56,560,2025-07-24
FC_TX03,SKU001430,1650,504,1146,210,2100,2025-07-25
FC_TX03,SKU001273,556,179,377,84,840,2025-07-23
FC_TX03,SKU001888,803,256,547,140,1400,2025-07-24
FC_TX03,SKU000803,644,181,463,112,1120,2025-07-26
FC_TX03,SKU001808,614,188,426,112,1120,2025-07-27
FC_TX03,SKU001487,564,170,394,84,840,2025-07-26
FC_TX03,SKU000688,845,224,621,140,1400,2025-07-23
FC_TX03,SKU000749,252,80,172,56,560,2025-07-25
FC_TX03,SKU001118,571,164,407,84,840,2025-07-26
FC_TX03,SKU001794,593,162,431,112,1120,2025-07-23
FC_TX03,SKU000203,552,142,410,84,840,2025-07-23
FC_TX03,SKU001468,603,169,434,112,1120,2025-07-25
FC_TX03,SKU000413,635,183,452,112,1120,2025-07-22
FC_TX03,SKU001782,825,220,605,140,1400,2025-07-26
FC_TX03,SKU001179,558,179,379,84,840,2025-07-23
FC_TX03,SKU001204,252,90,162,56,560,2025-07-23
FC_TX03,SKU000206,843,260,583,140,1400,2025-07-21
FC_TX03,SKU000923,247,80,167,56,560,2025-07-27
FC_TX03,SKU001318,535,175,360,84,840,2025-07-27
FC_TX03,SKU000069,1603,492,1111,210,2100,2025-07-21
FC_TX03,SKU000546,240,82,158,56,560,2025-07-23
FC_TX03,SKU001729,254,76,178,56,560,2025-07-24
FC_TX03,SKU000785,522,136,386,84,840,2025-07-24
FC_TX03,SKU001286,515,149,366,84,840,2025-07-24
FC_TX03,SKU000018,1529,447,1082,210,2100,2025-07-24
FC_TX03,SKU001424,1505,442,1063,210,2100,2025-07-25
FC_TX03,SKU000426,1548,472,1076,210,2100,2025-07-27
FC_TX03,SKU000289,540,148,392,84,840,2025-07-24
FC_TX03,SKU001177,568,179,389,84,840,2025-07-24
FC_TX03,SKU001965,1545,457,1088,210,2100,2025-07-23
FC_TX03,SKU001135,877,292,585,140,1400,2025-07-21
FC_TX03,SKU000709,558,163,395,84,840,2025-07-21
FC_TX03,SKU000985,581,172,409,84,840,2025-07-24
FC_TX03,SKU000820,1624,483,1141,210,2100,2025-07-24
FC_TX03,SKU000432,256,74,182,56,560,2025-07-25
FC_TX03,SKU000462,1679,489,1190,210,2100,2025-07-27
FC_TX03,SKU000381,829,256,573,140,1400,2025-07-26
FC_TX03,SKU000239,1580,500,1080,210,2100,2025-07-22
FC_TX03,SKU001616,267,71,196,56,560,2025-07-26
FC_TX03,SKU000739,858,275,583,140,1400,2025-07-26
FC_TX03,SKU001804,568,178,390,84,840,2025-07-23
FC_TX03,SKU000441,245,76,169,56,560,2025-07-21
FC_TX03,SKU001936,1528,482,1046,210,2100,2025-07-26
FC_TX03,SKU000418,569,174,395,84,840,2025-07-27
FC_TX03,SKU001026,1586,498,1088,210,2100,2025-07-21
FC_TX03,SKU001188,810,305,505,140,1400,2025-07-27
FC_TX03,SKU000562,806,233,573,140,1400,2025-07-21
FC_TX03,SKU000710,270,71,199,56,560,2025-07-27
FC_TX03,SKU001228,568,174,394,84,840,2025-07-27
FC_TX03,SKU000061,611,208,403,112,1120,2025-07-24
FC_TX03,SKU000175,657,195,462,112,1120,2025-07-25
FC_TX03,SKU001842,652,166,486,112,1120,2025-07-26
FC_TX03,SKU000782,776,252,524,140,1400,2025-07-26
FC_TX03,SKU000260,812,253,559,140,1400,2025-07-21
FC_TX03,SKU000056,537,136,401,84,840,2025-07-26
FC_TX03,SKU000074,1541,427,1114,210,2100,2025-07-21
FC_TX03,SKU000584,661,225,436,112,1120,2025-07-27
FC_TX03,SKU000834,571,170,401,112,1120,2025-07-25
FC_TX03,SKU000860,876,253,623,140,1400,2025-07-22
FC_TX03,SKU001704,578,176,402,112,1120,2025-07-22
FC_TX03,SKU000914,229,70,159,56,560,2025-07-21
FC_TX03,SKU001526,841,246,595,140,1400,2025-07-23
FC_TX03,SKU000349,582,161,421,112,1120,2025-07-25
FC_TX03,SKU000929,1616,524,1092,210,2100,2025-07-25
FC_TX03,SKU001300,610,188,422,112,1120,2025-07-22
FC_TX03,SKU001986,1623,489,1134,210,2100,2025-07-24
FC_TX03,SKU000234,498,135,363,84,840,2025-07-26
FC_TX03,SKU001482,828,277,551,140,1400,2025-07-25
FC_TX03,SKU001310,235,62,173,56,560,2025-07-22
FC_TX03,SKU001802,542,180,362,84,840,2025-07-21
FC_TX03,SKU001005,827,230,597,140,1400,2025-07-21
FC_TX03,SKU000338,608,185,423,112,1120,2025-07-21
FC_TX03,SKU001000,1615,510,1105,210,2100,2025-07-22
FC_TX03,SKU000155,1559,470,1089,210,2100,2025-07-27
FC_TX03,SKU001077,244,68,176,56,560,2025-07-21
FC_TX03,SKU000932,530,153,377,84,840,2025-07-25
FC_TX03,SKU001864,573,155,418,84,840,2025-07-26
FC_TX03,SKU001857,240,70,170,56,560,2025-07-25
FC_TX03,SKU001366,1587,462,1125,210,2100,2025-07-25
FC_TX03,SKU000340,588,172,416,112,1120,2025-07-21
FC_TX03,SKU001824,653,210,443,112,1120,2025-07-21
FC_TX03,SKU001832,616,185,431,112,1120,2025-07-21
FC_TX03,SKU000554,618,178,440,112,1120,2025-07-24
FC_TX03,SKU001256,229,76,153,56,560,2025-07-24
FC_TX03,SKU000882,531,146,385,84,840,2025-07-24
FC_TX03,SKU000533,249,72,177,56,560,2025-07-21
FC_TX03,SKU000126,1531,418,1113,210,2100,2025-07-25
FC_TX03,SKU000592,822,245,577,140,1400,2025-07-26
FC_TX03,SKU000378,817,289,528,140,1400,2025-07-25
FC_TX03,SKU000161,569,182,387,84,840,2025-07-23
FC_TX03,SKU001102,252,63,189,56,560,2025-07-21
FC_TX03,SKU001377,1510,458,1052,210,2100,2025-07-25
FC_TX03,SKU001067,1580,448,1132,210,2100,2025-07-26
FC_TX03,SKU001195,530,154,376,84,840,2025-07-22
FC_TX03,SKU001801,883,308,575,140,1400,2025-07-27
FC_TX03,SKU000810,648,198,450,112,1120,2025-07-25
FC_TX03,SKU000694,237,70,167,56,560,2025-07-26
FC_TX03,SKU001278,573,169,404,84,840,2025-07-22
FC_TX03,SKU000065,501,147,354,84,840,2025-07-23
FC_TX03,SKU000040,265,100,165,56,560,2025-07-21
FC_TX03,SKU000238,1655,511,1144,210,2100,2025-07-22
FC_TX03,SKU000276,549,175,374,84,840,2025-07-22
FC_TX03,SKU001508,814,252,562,140,1400,2025-07-26
FC_TX03,SKU000683,546,165,381,84,840,2025-07-24
FC_TX03,SKU000195,905,255,650,140,1400,2025-07-27
FC_TX03,SKU001446,267,90,177,56,560,2025-07-27
FC_TX03,SKU000261,630,184,446,112,1120,2025-07-23
FC_TX03,SKU001428,1617,481,1136,210,2100,2025-07-27
FC_TX03,SKU001290,243,69,174,56,560,2025-07-23
FC_TX03,SKU001292,613,181,432,112,1120,2025-07-27
FC_TX03,SKU001726,1493,447,1046,210,2100,2025-07-21
FC_TX03,SKU000223,245,71,174,56,560,2025-07-24
FC_TX03,SKU001427,520,158,362,84,840,2025-07-23
FC_TX03,SKU000250,605,169,436,112,1120,2025-07-26
FC_TX03,SKU001352,846,247,599,140,1400,2025-07-21
FC_TX03,SKU000590,647,187,460,112,1120,2025-07-22
FC_TX03,SKU000967,835,231,604,140,1400,2025-07-23
FC_TX03,SKU000817,1543,444,1099,210,2100,2025-07-26
FC_TX03,SKU001007,546,177,369,84,840,2025-07-25
FC_TX03,SKU000763,830,264,566,140,1400,2025-07-21
FC_TX03,SKU000280,540,139,401,84,840,2025-07-26
FC_TX03,SKU000597,559,153,406,84,840,2025-07-23
FC_TX03,SKU001582,839,244,595,140,1400,2025-07-21
FC_TX03,SKU001642,856,234,622,140,1400,2025-07-23
FC_TX03,SKU000041,558,187,371,112,1120,2025-07-22
FC_TX03,SKU001937,231,74,157,56,560,2025-07-24
FC_TX03,SKU000716,622,195,427,112,1120,2025-07-27
FC_TX03,SKU000111,267,64,203,56,560,2025-07-23
FC_TX03,SKU000002,520,157,363,84,840,2025-07-22
FC_TX03,SKU001656,777,228,549,140,1400,2025-07-23
FC_TX03,SKU000599,261,78,183,56,560,2025-07-26
FC_TX03,SKU001070,864,274,590,140,1400,2025-07-26
FC_TX03,SKU001328,609,185,424,112,1120,2025-07-25
FC_TX03,SKU000419,620,182,438,112,1120,2025-07-26
FC_TX03,SKU000727,1556,467,1089,210,2100,2025-07-26
FC_TX03,SKU000548,250,83,167,56,560,2025-07-26
FC_TX03,SKU000515,1568,460,1108,210,2100,2025-07-24
FC_TX03,SKU000637,559,158,401,84,840,2025-07-25
FC_TX03,SKU001740,539,166,373,84,840,2025-07-25
FC_TX03,SKU000070,1593,482,1111,210,2100,2025-07-27
FC_TX03,SKU001235,1565,463,1102,210,2100,2025-07-24
FC_TX03,SKU001991,591,193,398,112,1120,2025-07-23
FC_TX03,SKU001983,1546,468,1078,210,2100,2025-07-23
FC_TX03,SKU001266,614,200,414,112,1120,2025-07-24
FC_TX03,SKU000387,1560,443,1117,210,2100,2025-07-22
FC_TX03,SKU001922,875,293,582,140,1400,2025-07-24
FC_TX03,SKU001416,1641,480,1161,210,2100,2025-07-27
FC_TX03,SKU001505,1555,468,1087,210,2100,2025-07-24
FC_TX03,SKU000176,657,159,498,112,1120,2025-07-22
FC_TX03,SKU001517,232,70,162,56,560,2025-07-26
FC_TX03,SKU000252,592,193,399,112,1120,2025-07-27
FC_TX03,SKU000294,830,257,573,140,1400,2025-07-27
FC_TX03,SKU000673,590,181,409,112,1120,2025-07-27
FC_TX03,SKU000050,567,147,420,84,840,2025-07-21
FC_TX03,SKU001608,601,181,420,112,1120,2025-07-26
FC_TX03,SKU000906,236,72,164,56,560,2025-07-26
FC_TX03,SKU001532,541,160,381,84,840,2025-07-25
FC_TX03,SKU001655,591,154,437,112,1120,2025-07-26
FC_TX03,SKU000412,620,175,445,112,1120,2025-07-24
FC_TX03,SKU001213,1493,459,1034,210,2100,2025-07-26
FC_TX03,SKU001877,814,240,574,140,1400,2025-07-25
FC_TX03,SKU001996,577,162,415,84,840,2025-07-27
FC_TX03,SKU001309,245,78,167,56,560,2025-07-25
FC_TX03,SKU001110,270,77,193,56,560,2025-07-26
FC_TX03,SKU001267,876,264,612,140,1400,2025-07-27
FC_TX03,SKU000045,255,62,193,56,560,2025-07-25
FC_TX03,SKU000406,519,174,345,84,840,2025-07-25
FC_TX03,SKU000436,837,269,568,140,1400,2025-07-24
FC_TX03,SKU000189,240,56,184,56,560,2025-07-25
FC_TX03,SKU001940,1621,498,1123,210,2100,2025-07-22
FC_TX03,SKU001030,633,189,444,112,1120,2025-07-23
FC_TX03,SKU000909,494,166,328,84,840,2025-07-24
FC_TX03,SKU001803,1565,492,1073,210,2100,2025-07-22
FC_TX03,SKU001054,1484,436,1048,210,2100,2025-07-26
FC_TX03,SKU000940,618,184,434,112,1120,2025-07-27
FC_TX03,SKU001979,531,168,363,84,840,2025-07-23
FC_TX03,SKU000611,781,220,561,140,1400,2025-07-24
FC_TX03,SKU000319,235,62,173,56,560,2025-07-25
FC_TX03,SKU001076,608,192,416,112,1120,2025-07-27
FC_TX03,SKU000073,622,181,441,112,1120,2025-07-22
FC_TX03,SKU001119,1576,446,1130,210,2100,2025-07-27
FC_TX03,SKU001417,1570,444,1126,210,2100,2025-07-25
FC_TX03,SKU001335,822,244,578,140,1400,2025-07-22
FC_TX03,SKU001115,839,279,560,140,1400,2025-07-25
FC_TX03,SKU001342,538,171,367,84,840,2025-07-25
FC_TX03,SKU001367,546,161,385,84,840,2025-07-22
FC_TX03,SKU000991,795,226,569,140,1400,2025-07-23
FC_TX03,SKU000375,1550,454,1096,210,2100,2025-07-27
FC_TX03,SKU000352,517,146,371,84,840,2025-07-26
FC_TX03,SKU000227,245,70,175,56,560,2025-07-23
FC_TX03,SKU000057,508,157,351,84,840,2025-07-24
FC_TX03,SKU000863,578,184,394,84,840,2025-07-22
FC_TX03,SKU001289,623,167,456,112,1120,2025-07-22
FC_TX03,SKU001905,1554,453,1101,210,2100,2025-07-27
FC_TX03,SKU000305,242,68,174,56,560,2025-07-26
FC_TX03,SKU000142,214,65,149,56,560,2025-07-26
FC_TX03,SKU000184,554,148,406,84,840,2025-07-27
FC_TX03,SKU000121,560,165,395,84,840,2025-07-25
FC_TX03,SKU001374,520,157,363,84,840,2025-07-23
FC_TX03,SKU001901,542,153,389,84,840,2025-07-24
FC_TX03,SKU000564,633,184,449,112,1120,2025-07-21
FC_TX03,SKU001448,253,73,180,56,560,2025-07-24
FC_TX03,SKU000936,1559,445,1114,210,2100,2025-07-24
FC_TX03,SKU000059,494,143,351,84,840,2025-07-27
FC_TX03,SKU001330,841,244,597,140,1400,2025-07-26
FC_TX03,SKU001863,578,171,407,84,840,2025-07-26
FC_TX03,SKU000220,859,266,593,140,1400,2025-07-26
FC_TX03,SKU000342,572,170,402,112,1120,2025-07-24
FC_TX03,SKU000713,854,273,581,140,1400,2025-07-26
FC_TX03,SKU001954,1503,434,1069,210,2100,2025-07-25
FC_TX03,SKU000417,255,80,175,56,560,2025-07-23
FC_TX03,SKU000033,1583,504,1079,210,2100,2025-07-26
FC_TX03,SKU001191,539,153,386,84,840,2025-07-21
FC_TX03,SKU000043,1607,500,1107,210,2100,2025-07-21
FC_TX03,SKU000212,838,258,580,140,1400,2025-07-23
FC_TX03,SKU000613,247,93,154,56,560,2025-07-21
FC_TX03,SKU001333,1610,457,1153,210,2100,2025-07-27
FC_TX03,SKU001765,820,255,565,140,1400,2025-07-27
FC_TX03,SKU000960,561,196,365,84,840,2025-07-26
FC_TX03,SKU001209,281,92,189,56,560,2025-07-23
FC_TX03,SKU000229,235,76,159,56,560,2025-07-27
FC_TX03,SKU000700,235,94,141,56,560,2025-07-26
FC_TX03,SKU000538,866,281,585,140,1400,2025-07-27
FC_TX03,SKU001495,254,73,181,56,560,2025-07-26
FC_TX03,SKU001485,647,179,468,112,1120,2025-07-21
FC_TX03,SKU000850,1505,471,1034,210,2100,2025-07-25
FC_TX03,SKU001683,225,67,158,56,560,2025-07-27
FC_TX03,SKU000181,828,253,575,140,1400,2025-07-27
FC_TX03,SKU000668,874,266,608,140,1400,2025-07-27
FC_TX03,SKU001989,1529,464,1065,210,2100,2025-07-25
FC_TX03,SKU000814,1569,463,1106,210,2100,2025-07-26
FC_TX03,SKU000649,589,180,409,84,840,2025-07-24
FC_TX03,SKU000571,860,262,598,140,1400,2025-07-23
FC_TX03,SKU001184,644,183,461,112,1120,2025-07-21
FC_TX03,SKU000122,838,246,592,140,1400,2025-07-25
FC_TX03,SKU001050,613,204,409,112,1120,2025-07-21
FC_TX03,SKU000200,1544,483,1061,210,2100,2025-07-24
FC_TX03,SKU000891,545,164,381,84,840,2025-07-26
FC_TX03,SKU001748,582,187,395,84,840,2025-07-27
FC_TX03,SKU001152,582,174,408,84,840,2025-07-24
FC_TX03,SKU000804,226,65,161,56,560,2025-07-25
FC_TX03,SKU000410,560,145,415,84,840,2025-07-23
FC_TX03,SKU001772,514,167,347,84,840,2025-07-22
FC_TX03,SKU001051,549,179,370,84,840,2025-07-21
FC_TX03,SKU000593,819,241,578,140,1400,2025-07-25
FC_TX03,SKU001467,642,181,461,112,1120,2025-07-23
FC_TX03,SKU001475,267,75,192,56,560,2025-07-24
FC_TX03,SKU000885,537,149,388,84,840,2025-07-25
FC_TX03,SKU001130,1571,464,1107,210,2100,2025-07-25
FC_TX03,SKU000766,260,88,172,56,560,2025-07-22
FC_TX03,SKU000254,854,238,616,140,1400,2025-07-27
FC_TX03,SKU000060,504,147,357,84,840,2025-07-25
FC_TX03,SKU001326,252,79,173,56,560,2025-07-24
FC_TX03,SKU001317,1540,420,1120,210,2100,2025-07-22
FC_TX03,SKU000088,794,272,522,140,1400,2025-07-25
FC_TX03,SKU001388,539,191,348,84,840,2025-07-23
FC_TX03,SKU000540,854,276,578,140,1400,2025-07-22
FC_TX03,SKU001845,532,167,365,84,840,2025-07-22
FC_TX03,SKU001713,622,186,436,112,1120,2025-07-21
FC_TX03,SKU001611,811,230,581,140,1400,2025-07-24
FC_TX03,SKU000325,593,153,440,112,1120,2025-07-21
FC_TX03,SKU000549,525,162,363,84,840,2025-07-23
FC_TX03,SKU001170,765,231,534,140,1400,2025-07-27
FC_TX03,SKU000202,645,191,454,112,1120,2025-07-22
FC_TX03,SKU000883,820,238,582,140,1400,2025-07-27
FC_TX03,SKU001523,1536,465,1071,210,2100,2025-07-26
FC_TX03,SKU000800,534,170,364,84,840,2025-07-21
FC_TX03,SKU000898,610,173,437,112,1120,2025-07-27
FC_TX03,SKU000295,825,280,545,140,1400,2025-07-26
FC_TX03,SKU000114,254,76,178,56,560,2025-07-27
FC_TX03,SKU001095,826,229,597,140,1400,2025-07-26
FC_TX03,SKU001555,844,276,568,140,1400,2025-07-24
FC_TX03,SKU000164,638,202,436,112,1120,2025-07-22
FC_TX03,SKU001259,837,246,591,140,1400,2025-07-24
FC_TX03,SKU001798,276,80,196,56,560,2025-07-26
FC_TX03,SKU000628,236,71,165,56,560,2025-07-25
FC_TX03,SKU000511,216,42,174,56,560,2025-07-21
FC_TX03,SKU000813,561,172,389,84,840,2025-07-22
FC_TX03,SKU001674,820,222,598,140,1400,2025-07-26
FC_TX03,SKU001297,794,231,563,140,1400,2025-07-21
FC_TX03,SKU000720,1589,487,1102,210,2100,2025-07-25
FC_TX03,SKU000888,835,234,601,140,1400,2025-07-27
FC_TX03,SKU000759,530,151,379,84,840,2025-07-23
FC_TX03,SKU001237,593,169,424,84,840,2025-07-26
FC_TX03,SKU001654,257,60,197,56,560,2025-07-26
FC_TX03,SKU001913,570,175,395,84,840,2025-07-21
FC_TX03,SKU000440,880,258,622,140,1400,2025-07-22
FC_TX03,SKU000458,225,71,154,56,560,2025-07-25
FC_TX03,SKU001506,594,169,425,112,1120,2025-07-25
FC_TX03,SKU000483,263,92,171,56,560,2025-07-23
FC_TX03,SKU001288,574,162,412,84,840,2025-07-23
FC_TX03,SKU000170,858,233,625,140,1400,2025-07-25
FC_TX03,SKU000947,618,174,444,112,1120,2025-07-24
FC_TX03,SKU001542,826,246,580,140,1400,2025-07-21
FC_TX03,SKU000106,216,62,154,56,560,2025-07-22
FC_TX03,SKU001510,242,72,170,56,560,2025-07-24
FC_TX03,SKU001269,1631,481,1150,210,2100,2025-07-25
FC_TX03,SKU001460,255,70,185,56,560,2025-07-25
FC_TX03,SKU000025,565,157,408,84,840,2025-07-25
FC_TX03,SKU001168,1609,464,1145,210,2100,2025-07-22
FC_TX03,SKU001981,247,89,158,56,560,2025-07-25
FC_TX03,SKU000984,626,200,426,112,1120,2025-07-26
FC_TX03,SKU000236,827,262,565,140,1400,2025-07-27
FC_TX03,SKU001466,546,164,382,84,840,2025-07-26
FC_TX03,SKU000012,870,263,607,140,1400,2025-07-23
FC_TX03,SKU001351,824,219,605,140,1400,2025-07-24
FC_TX03,SKU001097,252,70,182,56,560,2025-07-22
FC_TX03,SKU001085,787,225,562,140,1400,2025-07-25
FC_TX03,SKU001984,542,156,386,84,840,2025-07-27
FC_TX03,SKU000439,263,69,194,56,560,2025-07-23
FC_TX03,SKU000552,1561,458,1103,210,2100,2025-07-22
FC_TX03,SKU001900,536,160,376,84,840,2025-07-21
FC_TX03,SKU000027,587,191,396,112,1120,2025-07-23
FC_TX03,SKU001885,624,184,440,112,1120,2025-07-22
FC_TX03,SKU000971,1571,491,1080,210,2100,2025-07-26
FC_TX03,SKU001792,853,249,604,140,1400,2025-07-22
FC_TX03,SKU000705,274,90,184,56,560,2025-07-22
FC_TX03,SKU000572,872,265,607,140,1400,2025-07-23
FC_TX03,SKU001738,1574,481,1093,210,2100,2025-07-21
FC_TX03,SKU001632,554,173,381,84,840,2025-07-27
FC_TX03,SKU001961,554,169,385,84,840,2025-07-21
FC_TX03,SKU001700,570,196,374,84,840,2025-07-21
FC_TX03,SKU000712,613,196,417,112,1120,2025-07-22
FC_TX03,SKU000917,566,169,397,84,840,2025-07-21
FC_TX03,SKU001861,1546,514,1032,210,2100,2025-07-24
FC_TX03,SKU000601,871,258,613,140,1400,2025-07-27
FC_TX03,SKU001331,1574,452,1122,210,2100,2025-07-21
FC_TX03,SKU000821,530,169,361,84,840,2025-07-21
FC_TX03,SKU001524,1524,460,1064,210,2100,2025-07-27
FC_TX03,SKU001743,885,274,611,140,1400,2025-07-24
FC_TX03,SKU001544,599,182,417,112,1120,2025-07-26
FC_TX03,SKU001970,825,224,601,140,1400,2025-07-24
FC_TX03,SKU000473,812,255,557,140,1400,2025-07-25
FC_TX03,SKU001594,824,246,578,140,1400,2025-07-25
FC_TX03,SKU001187,251,73,178,56,560,2025-07-26
FC_TX03,SKU001114,683,214,469,112,1120,2025-07-26
FC_TX03,SKU001664,252,64,188,56,560,2025-07-23
FC_TX03,SKU000208,266,79,187,56,560,2025-07-24
FC_TX03,SKU000838,882,254,628,140,1400,2025-07-23
FC_TX03,SKU000053,544,154,390,84,840,2025-07-22
FC_TX03,SKU000964,1497,461,1036,210,2100,2025-07-27
FC_TX03,SKU000258,1600,476,1124,210,2100,2025-07-23
FC_TX03,SKU000006,831,256,575,140,1400,2025-07-23
FC_TX03,SKU000219,258,78,180,56,560,2025-07-21
FC_TX03,SKU001509,635,198,437,112,1120,2025-07-23
FC_TX03,SKU000347,550,158,392,84,840,2025-07-22
FC_TX03,SKU000191,1644,507,1137,210,2100,2025-07-21
FC_TX03,SKU000192,1540,479,1061,210,2100,2025-07-27
FC_TX03,SKU000970,1526,473,1053,210,2100,2025-07-23
FC_TX03,SKU000010,246,69,177,56,560,2025-07-26
FC_TX03,SKU001398,596,167,429,84,840,2025-07-25
FC_TX03,SKU000028,1603,462,1141,210,2100,2025-07-24
FC_TX03,SKU001172,845,243,602,140,1400,2025-07-27
FC_TX03,SKU001295,1563,441,1122,210,2100,2025-07-24
FC_TX03,SKU000207,1626,472,1154,210,2100,2025-07-25
FC_TX03,SKU000722,602,157,445,112,1120,2025-07-27
FC_TX03,SKU000686,1571,464,1107,210,2100,2025-07-21
FC_TX03,SKU000502,850,269,581,140,1400,2025-07-27
FC_TX03,SKU001949,1602,478,1124,210,2100,2025-07-24
FC_TX03,SKU001206,547,181,366,84,840,2025-07-25
FC_TX03,SKU000894,631,179,452,112,1120,2025-07-27
FC_TX03,SKU001084,562,163,399,84,840,2025-07-27
FC_TX03,SKU000707,225,62,163,56,560,2025-07-23
FC_TX03,SKU000399,617,217,400,112,1120,2025-07-22
FC_TX03,SKU000789,609,164,445,112,1120,2025-07-26
FC_TX03,SKU000522,520,163,357,84,840,2025-07-24
FC_TX03,SKU001464,1553,485,1068,210,2100,2025-07-27
FC_TX03,SKU001942,204,53,151,56,560,2025-07-24
FC_TX03,SKU000506,638,174,464,112,1120,2025-07-25
FC_TX03,SKU000787,244,72,172,56,560,2025-07-26
FC_TX03,SKU001721,832,232,600,140,1400,2025-07-22
FC_TX03,SKU000332,851,274,577,140,1400,2025-07-26
FC_TX03,SKU000545,629,199,430,112,1120,2025-07-22
FC_TX03,SKU001673,561,165,396,84,840,2025-07-23
FC_TX03,SKU001455,632,183,449,112,1120,2025-07-26
FC_TX03,SKU000470,557,166,391,84,840,2025-07-21
FC_TX03,SKU001579,263,73,190,56,560,2025-07-22
FC_TX03,SKU001025,265,78,187,56,560,2025-07-24
FC_TX03,SKU000825,248,68,180,56,560,2025-07-24
FC_TX03,SKU001353,834,269,565,140,1400,2025-07-25
FC_TX03,SKU001866,1537,422,1115,210,2100,2025-07-27
FC_TX03,SKU001638,266,75,191,56,560,2025-07-24
FC_TX03,SKU001453,494,168,326,84,840,2025-07-25
FC_TX03,SKU001106,1581,488,1093,210,2100,2025-07-27
FC_TX03,SKU000844,809,245,564,140,1400,2025-07-27
FC_TX03,SKU001046,645,205,440,112,1120,2025-07-21
FC_TX03,SKU001752,236,68,168,56,560,2025-07-21
FC_TX03,SKU001928,607,203,404,112,1120,2025-07-25
FC_TX03,SKU000450,609,175,434,112,1120,2025-07-25
FC_TX03,SKU000918,614,173,441,112,1120,2025-07-21
FC_TX03,SKU000738,244,81,163,56,560,2025-07-27
FC_TX03,SKU000153,623,182,441,112,1120,2025-07-24
FC_TX03,SKU001068,547,171,376,84,840,2025-07-26
FC_TX03,SKU001844,568,186,382,112,1120,2025-07-27
FC_TX03,SKU001116,541,142,399,84,840,2025-07-23
FC_TX03,SKU001319,240,75,165,56,560,2025-07-21
FC_TX03,SKU001570,612,158,454,112,1120,2025-07-26
FC_TX03,SKU001401,528,162,366,84,840,2025-07-22
FC_TX03,SKU001314,255,66,189,56,560,2025-07-26
FC_TX03,SKU001355,245,69,176,56,560,2025-07-24
FC_TX03,SKU000575,852,255,597,140,1400,2025-07-25
FC_TX03,SKU000363,603,207,396,112,1120,2025-07-25
FC_TX03,SKU001770,1615,509,1106,210,2100,2025-07-27
FC_TX03,SKU001194,587,171,416,84,840,2025-07-27
FC_TX03,SKU000255,841,253,588,140,1400,2025-07-27
FC_TX03,SKU001838,1586,476,1110,210,2100,2025-07-27
FC_TX03,SKU001850,229,70,159,56,560,2025-07-27
FC_TX03,SKU001181,610,176,434,84,840,2025-07-23
FC_TX03,SKU001254,1584,465,1119,210,2100,2025-07-24
FC_TX03,SKU000915,253,67,186,56,560,2025-07-24
FC_TX03,SKU001403,238,63,175,56,560,2025-07-24
FC_TX03,SKU000912,290,91,199,56,560,2025-07-25
FC_TX03,SKU000314,1624,515,1109,210,2100,2025-07-23
FC_TX03,SKU001670,547,154,393,84,840,2025-07-21
FC_TX03,SKU000230,220,65,155,56,560,2025-07-22
FC_TX03,SKU000893,572,188,384,84,840,2025-07-27
FC_TX03,SKU001626,1500,433,1067,210,2100,2025-07-24
FC_TX03,SKU000237,1586,489,1097,210,2100,2025-07-22
FC_TX03,SKU000459,823,227,596,140,1400,2025-07-21
FC_TX03,SKU001587,252,66,186,56,560,2025-07-23
FC_TX03,SKU000636,896,269,627,140,1400,2025-07-26
FC_TX03,SKU001834,239,76,163,56,560,2025-07-24
FC_TX03,SKU000665,550,152,398,84,840,2025-07-23
FC_TX03,SKU001854,288,83,205,56,560,2025-07-27
FC_TX03,SKU001065,1594,457,1137,210,2100,2025-07-21
FC_TX03,SKU000054,1561,504,1057,210,2100,2025-07-27
FC_TX03,SKU000249,586,170,416,112,1120,2025-07-22
FC_TX03,SKU001511,249,69,180,56,560,2025-07-21
FC_TX03,SKU000383,1573,508,1065,210,2100,2025-07-22
FC_TX03,SKU001272,533,162,371,84,840,2025-07-22
FC_TX03,SKU001528,548,199,349,84,840,2025-07-21
FC_TX03,SKU001512,271,97,174,56,560,2025-07-23
FC_TX03,SKU001614,852,254,598,140,1400,2025-07-21
FC_TX03,SKU001956,1597,460,1137,210,2100,2025-07-25
FC_TX03,SKU000095,577,168,409,84,840,2025-07-22
FC_TX03,SKU001715,923,268,655,140,1400,2025-07-22
FC_TX03,SKU000831,824,241,583,140,1400,2025-07-27
FC_TX03,SKU000358,241,71,170,56,560,2025-07-25
FC_TX03,SKU000702,252,61,191,56,560,2025-07-21
FC_TX03,SKU001933,1593,481,1112,210,2100,2025-07-23
FC_TX03,SKU001214,1600,505,1095,210,2100,2025-07-25
FC_TX03,SKU001142,1581,519,1062,210,2100,2025-07-27
FC_TX03,SKU000561,258,80,178,56,560,2025-07-24
FC_TX03,SKU000108,1563,472,1091,210,2100,2025-07-21
FC_TX03,SKU000493,258,81,177,56,560,2025-07-24
FC_TX03,SKU000864,509,160,349,84,840,2025-07-24
FC_TX03,SKU000421,260,69,191,56,560,2025-07-22
FC_TX03,SKU000658,1578,482,1096,210,2100,2025-07-25
FC_TX03,SKU000868,819,265,554,140,1400,2025-07-25
FC_TX03,SKU001419,249,78,171,56,560,2025-07-23
FC_TX03,SKU000819,866,240,626,140,1400,2025-07-23
FC_TX03,SKU000256,667,215,452,112,1120,2025-07-26
FC_TX03,SKU000954,794,194,600,140,1400,2025-07-21
FC_TX03,SKU000977,214,64,150,56,560,2025-07-21
FC_TX03,SKU000972,574,158,416,84,840,2025-07-27
FC_TX03,SKU000308,802,260,542,140,1400,2025-07-26
FC_TX03,SKU000327,815,234,581,140,1400,2025-07-27
FC_TX03,SKU000092,890,278,612,140,1400,2025-07-26
FC_TX03,SKU001246,1559,462,1097,210,2100,2025-07-25
FC_TX03,SKU001039,623,183,440,112,1120,2025-07-21
FC_TX03,SKU001363,224,61,163,56,560,2025-07-21
FC_TX03,SKU001279,286,83,203,56,560,2025-07-21
FC_TX03,SKU001676,1617,475,1142,210,2100,2025-07-23
FC_TX03,SKU001903,224,79,145,56,560,2025-07-23
FC_TX03,SKU001380,241,62,179,56,560,2025-07-22
FC_TX03,SKU001963,555,167,388,84,840,2025-07-26
FC_TX03,SKU000606,845,254,591,140,1400,2025-07-21
FC_TX03,SKU001827,827,258,569,140,1400,2025-07-26
FC_TX03,SKU000859,593,183,410,112,1120,2025-07-23
FC_TX03,SKU001243,554,216,338,84,840,2025-07-24
FC_TX03,SKU001083,1625,510,1115,210,2100,2025-07-26
FC_TX03,SKU001219,643,166,477,112,1120,2025-07-27
FC_TX03,SKU001174,570,164,406,84,840,2025-07-24
FC_TX03,SKU001031,251,77,174,56,560,2025-07-23
FC_TX03,SKU000171,1614,483,1131,210,2100,2025-07-22
FC_TX03,SKU000992,252,82,170,56,560,2025-07-26
FC_TX03,SKU000807,244,80,164,56,560,2025-07-26
FC_TX03,SKU001420,591,177,414,84,840,2025-07-24
FC_TX03,SKU001521,592,196,396,84,840,2025-07-27
FC_TX03,SKU000453,1545,504,1041,210,2100,2025-07-24
FC_TX03,SKU000042,1635,495,1140,210,2100,2025-07-26
FC_TX03,SKU001776,833,248,585,140,1400,2025-07-24
FC_TX03,SKU000723,625,195,430,112,1120,2025-07-23
FC_TX03,SKU001581,794,229,565,140,1400,2025-07-21
FC_TX03,SKU000320,1597,490,1107,210,2100,2025-07-21
FC_TX03,SKU000003,622,200,422,112,1120,2025-07-23
FC_TX03,SKU000400,1621,483,1138,210,2100,2025-07-22
FC_TX03,SKU001253,240,74,166,56,560,2025-07-23
FC_TX03,SKU000980,278,86,192,56,560,2025-07-23
FC_TX03,SKU000204,526,172,354,84,840,2025-07-27
FC_TX03,SKU001412,542,173,369,84,840,2025-07-25
FC_TX03,SKU001599,585,164,421,112,1120,2025-07-24
FC_TX03,SKU000355,805,244,561,140,1400,2025-07-23
FC_TX03,SKU000465,868,249,619,140,1400,2025-07-26
FC_TX03,SKU000407,558,167,391,112,1120,2025-07-26
FC_TX03,SKU001406,648,190,458,112,1120,2025-07-26
FC_TX03,SKU001562,643,211,432,112,1120,2025-07-23
FC_TX03,SKU000339,839,230,609,140,1400,2025-07-21
FC_TX03,SKU000701,1615,433,1182,210,2100,2025-07-25
FC_TX03,SKU000563,828,247,581,140,1400,2025-07-27
FC_TX03,SKU000371,583,172,411,112,1120,2025-07-25
FC_TX03,SKU001742,555,168,387,84,840,2025-07-27
FC_TX03,SKU001603,248,83,165,56,560,2025-07-23
FC_TX03,SKU000487,245,71,174,56,560,2025-07-21
FC_TX03,SKU001980,799,243,556,140,1400,2025-07-26
FC_TX03,SKU001968,556,171,385,84,840,2025-07-24
FC_TX03,SKU000877,1552,491,1061,210,2100,2025-07-25
FC_TX03,SKU000744,805,272,533,140,1400,2025-07-26
FC_TX03,SKU001038,1621,464,1157,210,2100,2025-07-27
FC_TX03,SKU001975,841,258,583,140,1400,2025-07-22
FC_TX03,SKU001720,1593,472,1121,210,2100,2025-07-22
FC_TX03,SKU000530,634,191,443,112,1120,2025-07-24
FC_TX03,SKU001635,563,166,397,84,840,2025-07-23
FC_TX03,SKU000678,1622,509,1113,210,2100,2025-07-22
FC_TX03,SKU001781,257,71,186,56,560,2025-07-22
FC_TX03,SKU001303,1515,443,1072,210,2100,2025-07-21
FC_TX03,SKU001324,624,163,461,112,1120,2025-07-22
FC_TX03,SKU001483,1548,463,1085,210,2100,2025-07-25
FC_TX03,SKU000835,1611,533,1078,210,2100,2025-07-25
FC_TX03,SKU000197,1582,460,1122,210,2100,2025-07-27
FC_TX03,SKU000331,1521,433,1088,210,2100,2025-07-27
FC_TX03,SKU001019,1511,472,1039,210,2100,2025-07-27
FC_TX03,SKU001751,662,194,468,112,1120,2025-07-23
FC_TX03,SKU001540,736,221,515,140,1400,2025-07-23
FC_TX03,SKU000775,561,167,394,84,840,2025-07-23
FC_TX03,SKU000651,836,261,575,140,1400,2025-07-21
FC_TX03,SKU001771,536,157,379,84,840,2025-07-26
FC_TX03,SKU000944,237,70,167,56,560,2025-07-27
FC_TX03,SKU000587,806,244,562,140,1400,2025-07-22
FC_TX03,SKU000585,272,78,194,56,560,2025-07-24
FC_TX03,SKU000404,600,182,418,112,1120,2025-07-22
FC_TX03,SKU001789,244,64,180,56,560,2025-07-22
FC_TX03,SKU001003,1649,463,1186,210,2100,2025-07-25
FC_TX03,SKU000586,631,178,453,112,1120,2025-07-26
FC_TX03,SKU000315,645,211,434,112,1120,2025-07-21
FC_TX03,SKU001768,229,59,170,56,560,2025-07-26
FC_TX03,SKU001825,575,164,411,84,840,2025-07-26
FC_TX03,SKU001362,535,179,356,84,840,2025-07-21
FC_TX03,SKU000079,624,172,452,112,1120,2025-07-26
FC_TX03,SKU001941,630,204,426,112,1120,2025-07-27
FC_TX03,SKU001992,249,68,181,56,560,2025-07-23
FC_TX03,SKU000198,1567,484,1083,210,2100,2025-07-24
FC_TX03,SKU000849,1625,514,1111,210,2100,2025-07-24
FC_TX03,SKU001589,1564,489,1075,210,2100,2025-07-25
FC_TX03,SKU001045,214,68,146,56,560,2025-07-24
FC_TX03,SKU000588,803,253,550,140,1400,2025-07-26
FC_TX03,SKU000853,1606,497,1109,210,2100,2025-07-24
FC_TX03,SKU000067,1590,481,1109,210,2100,2025-07-26
FC_TX03,SKU001332,279,87,192,56,560,2025-07-21
FC_TX03,SKU000952,528,155,373,84,840,2025-07-22
FC_TX03,SKU000486,1561,443,1118,210,2100,2025-07-23
FC_TX03,SKU001073,589,162,427,112,1120,2025-07-22
FC_TX03,SKU000118,843,244,599,140,1400,2025-07-25
FC_TX03,SKU000913,1516,456,1060,210,2100,2025-07-26
FC_TX03,SKU001149,538,166,372,84,840,2025-07-27
FC_TX03,SKU000732,851,250,601,140,1400,2025-07-26
FC_TX03,SKU001044,535,185,350,84,840,2025-07-23
FC_TX03,SKU001473,561,168,393,84,840,2025-07-22
FC_TX03,SKU000994,241,60,181,56,560,2025-07-21
FC_TX03,SKU000109,613,158,455,112,1120,2025-07-22
FC_TX03,SKU001364,525,158,367,84,840,2025-07-24
FC_TX03,SKU001236,612,193,419,112,1120,2025-07-22
FC_TX03,SKU000666,803,229,574,140,1400,2025-07-25
FC_TX03,SKU000265,857,260,597,140,1400,2025-07-24
FC_TX03,SKU000922,258,78,180,56,560,2025-07-24
FC_TX03,SKU001536,229,62,167,56,560,2025-07-26
FC_TX03,SKU001939,538,181,357,84,840,2025-07-23
FC_TX03,SKU000671,1540,461,1079,210,2100,2025-07-27
FC_TX03,SKU001491,280,74,206,56,560,2025-07-24
FC_TX03,SKU000989,623,186,437,112,1120,2025-07-26
FC_TX03,SKU000296,242,99,143,56,560,2025-07-27
FC_TX03,SKU001595,1563,452,1111,210,2100,2025-07-24
FC_TX03,SKU001750,1559,448,1111,210,2100,2025-07-25
FC_TX03,SKU000693,224,74,150,56,560,2025-07-27
FC_TX03,SKU001618,805,245,560,140,1400,2025-07-23
FC_TX03,SKU000262,268,80,188,56,560,2025-07-22
FC_TX03,SKU001628,566,171,395,112,1120,2025-07-21
FC_TX03,SKU000125,1559,481,1078,210,2100,2025-07-27
FC_TX03,SKU000271,596,169,427,112,1120,2025-07-21
FC_TX03,SKU001976,250,73,177,56,560,2025-07-23
FC_TX03,SKU001287,577,191,386,84,840,2025-07-25
FC_TX03,SKU001379,521,165,356,84,840,2025-07-27
FC_TX03,SKU000747,1646,481,1165,210,2100,2025-07-25
FC_TX03,SKU001138,1630,544,1086,210,2100,2025-07-27
FC_TX03,SKU001741,860,270,590,140,1400,2025-07-26
FC_TX03,SKU001672,533,165,368,84,840,2025-07-22
FC_TX03,SKU001053,576,175,401,84,840,2025-07-25
FC_TX03,SKU000288,544,165,379,84,840,2025-07-23
FC_TX03,SKU000001,496,150,346,84,840,2025-07-23
FC_TX03,SKU000201,607,215,392,84,840,2025-07-26
FC_TX03,SKU001692,241,68,173,56,560,2025-07-25
FC_TX03,SKU001376,603,174,429,112,1120,2025-07-21
FC_TX03,SKU001633,546,169,377,84,840,2025-07-23
FC_TX03,SKU000036,826,229,597,140,1400,2025-07-26
FC_TX03,SKU001819,529,157,372,84,840,2025-07-21
FC_TX03,SKU001218,828,235,593,140,1400,2025-07-22
FC_TX03,SKU001648,253,80,173,56,560,2025-07-25
FC_TX03,SKU001730,246,68,178,56,560,2025-07-24
FC_TX03,SKU001436,634,210,424,112,1120,2025-07-23
FC_TX03,SKU000285,567,141,426,84,840,2025-07-22
FC_TX03,SKU000087,660,189,471,112,1120,2025-07-21
FC_TX03,SKU002000,530,156,374,84,840,2025-07-23
FC_TX03,SKU000443,1630,510,1120,210,2100,2025-07-23
FC_TX03,SKU001408,1687,480,1207,210,2100,2025-07-27
FC_TX03,SKU001774,1497,463,1034,210,2100,2025-07-26
FC_TX03,SKU001502,518,138,380,84,840,2025-07-22
FC_TX03,SKU001423,857,258,599,140,1400,2025-07-27
FC_TX03,SKU001432,868,253,615,140,1400,2025-07-27
FC_TX03,SKU000287,543,169,374,84,840,2025-07-21
FC_TX03,SKU001718,559,168,391,84,840,2025-07-26
FC_TX03,SKU000163,1515,466,1049,210,2100,2025-07-24
FC_TX03,SKU000110,801,238,563,140,1400,2025-07-26
FC_TX03,SKU000718,529,158,371,84,840,2025-07-26
FC_TX03,SKU000568,234,63,171,56,560,2025-07-24
FC_TX03,SKU000630,1577,515,1062,210,2100,2025-07-27
FC_TX03,SKU000348,602,167,435,112,1120,2025-07-26
FC_TX03,SKU000773,538,165,373,84,840,2025-07-21
FC_TX03,SKU000792,1570,478,1092,210,2100,2025-07-25
FC_TX03,SKU000534,567,169,398,84,840,2025-07-24
FC_TX03,SKU000467,260,76,184,56,560,2025-07-21
FC_TX03,SKU001835,572,161,411,84,840,2025-07-22
FC_TX03,SKU001463,592,175,417,112,1120,2025-07-27
FC_TX03,SKU000063,263,76,187,56,560,2025-07-25
FC_TX03,SKU000093,819,247,572,140,1400,2025-07-24
FC_TX03,SKU001814,880,277,603,140,1400,2025-07-23
FC_TX03,SKU001139,1552,443,1109,210,2100,2025-07-23
FC_TX03,SKU000847,255,92,163,56,560,2025-07-25
FC_TX03,SKU000444,523,170,353,84,840,2025-07-26
FC_TX03,SKU001559,1520,448,1072,210,2100,2025-07-22
FC_TX03,SKU001457,1567,488,1079,210,2100,2025-07-23
FC_TX03,SKU000643,873,240,633,140,1400,2025-07-25
FC_TX03,SKU001001,1597,486,1111,210,2100,2025-07-21
FC_TX03,SKU001107,631,180,451,112,1120,2025-07-23
FC_TX03,SKU000973,265,79,186,56,560,2025-07-21
FC_TX03,SKU000878,631,186,445,112,1120,2025-07-21
FC_TX03,SKU001790,261,73,188,56,560,2025-07-22
FC_TX03,SKU000717,237,67,170,56,560,2025-07-27
FC_TX03,SKU000731,547,190,357,84,840,2025-07-26
FC_TX03,SKU001049,582,176,406,84,840,2025-07-21
FC_TX03,SKU000398,256,87,169,56,560,2025-07-21
FC_TX03,SKU000343,1548,459,1089,210,2100,2025-07-21
FC_TX03,SKU001679,1599,460,1139,210,2100,2025-07-21
FC_TX03,SKU001538,827,266,561,140,1400,2025-07-27
FC_TX03,SKU001325,553,167,386,112,1120,2025-07-22
FC_TX03,SKU001087,268,96,172,56,560,2025-07-23
FC_TX03,SKU000704,567,172,395,84,840,2025-07-22
FC_TX03,SKU001534,1535,502,1033,210,2100,2025-07-21
FC_TX03,SKU001397,526,150,376,84,840,2025-07-25
FC_TX03,SKU001062,245,53,192,56,560,2025-07-23
FC_TX03,SKU000011,536,159,377,84,840,2025-07-22
FC_TX03,SKU000711,632,186,446,112,1120,2025-07-23
FC_TX03,SKU000144,600,165,435,112,1120,2025-07-21
FC_TX03,SKU001816,262,87,175,56,560,2025-07-27
FC_TX03,SKU000422,252,78,174,56,560,2025-07-23
FC_TX03,SKU000179,247,69,178,56,560,2025-07-27
FC_TX03,SKU001636,636,173,463,112,1120,2025-07-25
FC_TX03,SKU001821,254,68,186,56,560,2025-07-25
FC_TX03,SKU001791,832,218,614,140,1400,2025-07-21
FC_TX03,SKU001663,535,157,378,84,840,2025-07-27
FC_TX03,SKU000376,1589,450,1139,210,2100,2025-07-27
FC_TX03,SKU000169,623,188,435,112,1120,2025-07-27
FC_TX03,SKU001395,606,177,429,112,1120,2025-07-21
FC_TX03,SKU001906,599,184,415,84,840,2025-07-24
FC_TX03,SKU001074,223,81,142,56,560,2025-07-26
FC_TX03,SKU000194,628,213,415,112,1120,2025-07-25
FC_TX03,SKU000049,820,257,563,140,1400,2025-07-21
FC_TX03,SKU000674,233,75,158,56,560,2025-07-26
FC_TX03,SKU001265,812,240,572,140,1400,2025-07-22
FC_TX03,SKU000037,613,183,430,112,1120,2025-07-21
FC_TX03,SKU000870,1552,487,1065,210,2100,2025-07-22
FC_TX03,SKU000598,557,166,391,84,840,2025-07-24
FC_TX03,SKU001208,811,205,606,140,1400,2025-07-26
FC_TX03,SKU001658,679,185,494,112,1120,2025-07-27
FC_TX03,SKU001912,910,273,637,140,1400,2025-07-23
FC_TX03,SKU000116,1549,479,1070,210,2100,2025-07-24
FC_TX03,SKU000004,1569,474,1095,210,2100,2025-07-26
FC_TX03,SKU001242,865,246,619,140,1400,2025-07-25
FC_TX03,SKU000369,864,272,592,140,1400,2025-07-27
FC_TX03,SKU001393,271,81,190,56,560,2025-07-22
FC_TX03,SKU000389,599,176,423,112,1120,2025-07-22
FC_TX03,SKU001735,1597,485,1112,210,2100,2025-07-26
FC_TX03,SKU001617,560,148,412,84,840,2025-07-23
FC_TX03,SKU000217,248,81,167,56,560,2025-07-27
FC_TX03,SKU000610,256,87,169,56,560,2025-07-21
FC_TX03,SKU000679,606,192,414,84,840,2025-07-25
FC_TX03,SKU001744,609,175,434,112,1120,2025-07-26
FC_TX03,SKU000695,627,201,426,112,1120,2025-07-24
FC_TX03,SKU000942,558,180,378,112,1120,2025-07-21
FC_TX03,SKU000660,585,169,416,112,1120,2025-07-25
FC_TX03,SKU001539,653,228,425,112,1120,2025-07-27
FC_TX03,SKU000650,879,267,612,140,1400,2025-07-27
FC_TX03,SKU001471,854,235,619,140,1400,2025-07-27
FC_TX03,SKU000105,1574,451,1123,210,2100,2025-07-25
FC_TX03,SKU001112,250,81,169,56,560,2025-07-26
FC_TX03,SKU000149,645,182,463,112,1120,2025-07-26
FC_TX03,SKU000150,835,223,612,140,1400,2025-07-21
FC_TX03,SKU000186,586,162,424,112,1120,2025-07-23
FC_TX03,SKU000507,1627,480,1147,210,2100,2025-07-26
FC_TX03,SKU000770,852,220,632,140,1400,2025-07-23
FC_TX03,SKU001602,848,249,599,140,1400,2025-07-22
FC_TX03,SKU001389,526,168,358,84,840,2025-07-26
FC_TX03,SKU000653,273,92,181,56,560,2025-07-21
FC_TX03,SKU000291,1574,474,1100,210,2100,2025-07-23
FC_TX03,SKU001535,841,261,580,140,1400,2025-07-25
FC_TX03,SKU000353,1583,515,1068,210,2100,2025-07-21
FC_TX03,SKU000670,519,158,361,84,840,2025-07-22
FC_TX03,SKU000309,550,160,390,84,840,2025-07-24
FC_TX03,SKU001383,252,72,180,56,560,2025-07-25
FC_TX03,SKU001089,590,210,380,84,840,2025-07-21
FC_TX03,SKU001479,582,178,404,112,1120,2025-07-25
FC_TX03,SKU001058,252,64,188,56,560,2025-07-23
FC_TX03,SKU000038,1589,494,1095,210,2100,2025-07-22
FC_TX03,SKU000627,527,165,362,84,840,2025-07-26
FC_TX03,SKU001815,822,250,572,140,1400,2025-07-21
FC_TX03,SKU000137,1608,494,1114,210,2100,2025-07-25
FC_TX03,SKU001439,1538,471,1067,210,2100,2025-07-22
FC_TX03,SKU001849,251,71,180,56,560,2025-07-24
FC_TX03,SKU001199,252,79,173,56,560,2025-07-22
FC_TX03,SKU001171,1532,486,1046,210,2100,2025-07-26
FC_TX03,SKU000303,261,68,193,56,560,2025-07-24
FC_TX03,SKU000577,805,228,577,140,1400,2025-07-24
FC_TX03,SKU001098,1579,505,1074,210,2100,2025-07-26
FC_TX03,SKU001211,610,181,429,112,1120,2025-07-24
FC_TX03,SKU001281,1550,469,1081,210,2100,2025-07-25
FC_TX03,SKU001799,1559,446,1113,210,2100,2025-07-27
FC_TX03,SKU001212,844,257,587,140,1400,2025-07-26
FC_TX03,SKU000253,562,150,412,84,840,2025-07-25
FC_TX03,SKU001568,784,243,541,140,1400,2025-07-26
FC_TX03,SKU001241,588,182,406,112,1120,2025-07-25
FC_TX03,SKU000698,1521,474,1047,210,2100,2025-07-24
FC_TX03,SKU000469,1572,477,1095,210,2100,2025-07-25
FC_TX03,SKU001706,262,76,186,56,560,2025-07-22
FC_TX03,SKU000124,282,104,178,56,560,2025-07-24
FC_TX03,SKU000279,1558,452,1106,210,2100,2025-07-23
FC_TX03,SKU000969,252,85,167,56,560,2025-07-27
FC_TX03,SKU001698,830,242,588,140,1400,2025-07-24
FC_TX03,SKU001723,819,254,565,140,1400,2025-07-21
FC_TX03,SKU001402,541,164,377,84,840,2025-07-21
FC_TX03,SKU000684,787,222,565,140,1400,2025-07-21
FC_TX03,SKU001449,1613,554,1059,210,2100,2025-07-21
FC_TX03,SKU001525,1609,503,1106,210,2100,2025-07-22
FC_TX03,SKU000941,222,54,168,56,560,2025-07-23
FC_TX03,SKU000221,1594,513,1081,210,2100,2025-07-26
FC_TX03,SKU000603,540,172,368,84,840,2025-07-24
FC_TX03,SKU001780,518,154,364,84,840,2025-07-23
FC_TX03,SKU000156,233,68,165,56,560,2025-07-26
FC_TX03,SKU000322,866,285,581,140,1400,2025-07-27
FC_TX03,SKU000634,1561,514,1047,210,2100,2025-07-24
FC_TX03,SKU001985,567,159,408,84,840,2025-07-26
FC_TX03,SKU001631,852,252,600,140,1400,2025-07-22
FC_TX03,SKU001826,617,184,433,112,1120,2025-07-21
FC_TX03,SKU000624,834,268,566,140,1400,2025-07-26
FC_TX03,SKU000290,544,174,370,84,840,2025-07-23
FC_TX03,SKU001144,505,142,363,84,840,2025-07-27
FC_TX03,SKU000306,830,252,578,140,1400,2025-07-23
FC_TX03,SKU001573,666,189,477,112,1120,2025-07-23
FC_TX03,SKU001820,602,166,436,112,1120,2025-07-23
FC_TX03,SKU001733,627,201,426,112,1120,2025-07-22
FC_TX03,SKU000531,638,182,456,112,1120,2025-07-24
FC_TX03,SKU001788,256,51,205,56,560,2025-07-27
FC_TX03,SKU001452,247,79,168,56,560,2025-07-23
FC_TX03,SKU001017,929,278,651,140,1400,2025-07-23
FC_TX03,SKU001818,1625,448,1177,210,2100,2025-07-26
FC_TX03,SKU000210,572,177,395,84,840,2025-07-26
FC_TX03,SKU001215,632,195,437,112,1120,2025-07-22
FC_TX03,SKU000976,625,187,438,112,1120,2025-07-22
FC_TX03,SKU001914,833,228,605,140,1400,2025-07-23
FC_TX03,SKU000919,853,229,624,140,1400,2025-07-23
FC_TX03,SKU000304,826,248,578,140,1400,2025-07-24
FC_TX03,SKU001646,543,182,361,84,840,2025-07-24
FC_TX03,SKU001390,591,178,413,84,840,2025-07-21
FC_TX03,SKU001701,826,258,568,140,1400,2025-07-22
FC_TX03,SKU001207,845,236,609,140,1400,2025-07-25
FC_TX03,SKU000180,821,215,606,140,1400,2025-07-24
FC_TX03,SKU001504,274,83,191,56,560,2025-07-22
FC_TX03,SKU000138,605,167,438,112,1120,2025-07-26
FC_TX03,SKU000345,1522,478,1044,210,2100,2025-07-26
FC_TX03,SKU000379,622,196,426,112,1120,2025-07-25
FC_TX03,SKU000434,238,82,156,56,560,2025-07-25
FC_TX03,SKU001640,621,203,418,112,1120,2025-07-26
FC_TX03,SKU001623,569,174,395,112,1120,2025-07-27
FC_TX03,SKU001775,617,190,427,112,1120,2025-07-26
FC_TX03,SKU000518,619,186,433,112,1120,2025-07-26
FC_TX03,SKU000645,599,177,422,112,1120,2025-07-21
FC_TX03,SKU000365,1552,460,1092,210,2100,2025-07-21
FC_TX03,SKU001899,1586,459,1127,210,2100,2025-07-21
FC_TX03,SKU000757,275,84,191,56,560,2025-07-21
FC_TX03,SKU001919,835,269,566,140,1400,2025-07-21
FC_TX03,SKU001371,520,139,381,84,840,2025-07-25
FC_TX03,SKU000132,238,81,157,56,560,2025-07-22
FC_TX03,SKU001972,203,54,149,56,560,2025-07-22
FC_TX03,SKU001109,611,180,431,112,1120,2025-07-27
FC_TX03,SKU001461,264,64,200,56,560,2025-07-25
FC_TX03,SKU000374,640,176,464,112,1120,2025-07-22
FC_TX03,SKU001787,866,281,585,140,1400,2025-07-24
FC_TX03,SKU000167,583,175,408,112,1120,2025-07-27
FC_TX03,SKU001952,855,227,628,140,1400,2025-07-23
FC_TX03,SKU001746,842,249,593,140,1400,2025-07-23
FC_TX03,SKU000754,268,84,184,56,560,2025-07-23
FC_TX03,SKU001275,243,99,144,56,560,2025-07-24
FC_TX03,SKU001809,551,146,405,84,840,2025-07-27
FC_TX03,SKU000635,585,188,397,84,840,2025-07-22
FC_TX03,SKU000307,842,264,578,140,1400,2025-07-24
FC_TX03,SKU001583,587,197,390,84,840,2025-07-21
FC_TX03,SKU001113,866,259,607,140,1400,2025-07-22
FC_TX03,SKU000676,1652,515,1137,210,2100,2025-07-25
FC_TX03,SKU000948,1581,464,1117,210,2100,2025-07-25
FC_TX03,SKU000120,657,209,448,112,1120,2025-07-23
FC_TX03,SKU000547,839,275,564,140,1400,2025-07-22
FC_TX03,SKU001028,832,271,561,140,1400,2025-07-24
FC_TX03,SKU000626,609,174,435,112,1120,2025-07-25
FC_TX03,SKU000076,888,275,613,140,1400,2025-07-25
FC_TX03,SKU000555,234,77,157,56,560,2025-07-27
FC_TX03,SKU001249,627,177,450,112,1120,2025-07-21
FC_TX03,SKU000312,833,261,572,140,1400,2025-07-21
FC_TX03,SKU001693,667,200,467,112,1120,2025-07-27
FC_TX03,SKU000827,526,149,377,84,840,2025-07-26
FC_TX03,SKU000317,633,205,428,112,1120,2025-07-25
FC_TX03,SKU001777,574,155,419,84,840,2025-07-27
FC_TX03,SKU001946,896,268,628,140,1400,2025-07-25
FC_TX03,SKU001894,568,164,404,84,840,2025-07-26
FC_TX03,SKU000862,563,175,388,84,840,2025-07-24
FC_TX03,SKU000286,830,236,594,140,1400,2025-07-22
FC_TX03,SKU001165,540,159,381,84,840,2025-07-23
FC_TX03,SKU000336,575,167,408,84,840,2025-07-22
FC_TX03,SKU000082,634,165,469,112,1120,2025-07-27
FC_TX03,SKU001620,828,269,559,140,1400,2025-07-23
FC_TX03,SKU000173,1535,457,1078,210,2100,2025-07-27
FC_TX03,SKU000687,575,170,405,84,840,2025-07-22
FC_TX03,SKU000911,234,80,154,56,560,2025-07-23
FC_TX03,SKU001202,574,172,402,84,840,2025-07-26
FC_TX03,SKU000907,548,186,362,84,840,2025-07-21
FC_TX03,SKU000535,233,73,160,56,560,2025-07-27
FC_TX03,SKU001121,279,71,208,56,560,2025-07-24
FC_TX03,SKU001153,518,158,360,84,840,2025-07-24
FC_TX03,SKU000524,847,285,562,140,1400,2025-07-24
FC_TX03,SKU000310,822,233,589,140,1400,2025-07-25
FC_TX03,SKU001033,794,231,563,140,1400,2025-07-27
FC_TX03,SKU001556,530,160,370,84,840,2025-07-24
FC_TX03,SKU001869,579,162,417,84,840,2025-07-21
FC_TX03,SKU000449,254,84,170,56,560,2025-07-22
FC_TX03,SKU000187,526,183,343,84,840,2025-07-23
FC_TX03,SKU001291,1575,554,1021,210,2100,2025-07-27
FC_TX03,SKU000501,266,65,201,56,560,2025-07-22
FC_TX03,SKU001047,862,254,608,140,1400,2025-07-23
FC_TX03,SKU000730,476,143,333,84,840,2025-07-27
FC_TX03,SKU001522,644,216,428,112,1120,2025-07-25
FC_TX03,SKU000474,874,248,626,140,1400,2025-07-24
FC_TX03,SKU000416,255,75,180,56,560,2025-07-22
FC_TX03,SKU000779,1528,461,1067,210,2100,2025-07-27
FC_TX03,SKU001315,783,229,554,140,1400,2025-07-24
FC_TX03,SKU001258,607,174,433,112,1120,2025-07-23
FC_TX03,SKU001216,633,180,453,112,1120,2025-07-23
FC_TX03,SKU001898,513,156,357,84,840,2025-07-22
FC_TX03,SKU001229,256,79,177,56,560,2025-07-25
FC_TX03,SKU001481,1563,472,1091,210,2100,2025-07-24
FC_TX03,SKU000401,810,245,565,140,1400,2025-07-24
FC_TX03,SKU001690,561,171,390,84,840,2025-07-26
FC_TX03,SKU000324,1579,471,1108,210,2100,2025-07-21
FC_TX03,SKU001012,239,67,172,56,560,2025-07-21
FC_TX03,SKU001915,1593,477,1116,210,2100,2025-07-26
FC_TX03,SKU000884,629,190,439,112,1120,2025-07-26
FC_TX03,SKU001384,1570,442,1128,210,2100,2025-07-24
FC_TX03,SKU001639,1624,460,1164,210,2100,2025-07-23
FC_TX03,SKU000504,518,170,348,84,840,2025-07-26
FC_TX03,SKU001378,639,174,465,112,1120,2025-07-21
FC_TX03,SKU000872,899,268,631,140,1400,2025-07-21
FC_TX03,SKU001597,839,251,588,140,1400,2025-07-21
FC_TX03,SKU000127,613,173,440,112,1120,2025-07-26
FC_TX03,SKU001231,869,254,615,140,1400,2025-07-25
FC_TX03,SKU001795,819,258,561,140,1400,2025-07-23
FC_TX03,SKU001755,1609,456,1153,210,2100,2025-07-25
FC_TX03,SKU001064,1533,493,1040,210,2100,2025-07-21
FC_TX03,SKU000595,1583,490,1093,210,2100,2025-07-25
FC_TX03,SKU001052,863,244,619,140,1400,2025-07-24
FC_TX03,SKU001829,1605,484,1121,210,2100,2025-07-27
FC_TX03,SKU001537,781,228,553,140,1400,2025-07-26
FC_TX03,SKU001196,849,247,602,140,1400,2025-07-22
FC_TX03,SKU001444,252,77,175,56,560,2025-07-23
FC_TX03,SKU001950,872,270,602,140,1400,2025-07-26
FC_TX03,SKU001785,1621,453,1168,210,2100,2025-07-23
FC_TX03,SKU001015,272,79,193,56,560,2025-07-21
FC_TX03,SKU001612,528,150,378,84,840,2025-07-21
FC_TX03,SKU000962,529,171,358,84,840,2025-07-27
FC_TX03,SKU001907,1580,528,1052,210,2100,2025-07-22
FC_TX03,SKU000806,523,151,372,84,840,2025-07-25
FC_TX03,SKU000908,533,156,377,84,840,2025-07-23
FC_TX03,SKU000113,560,160,400,84,840,2025-07-26
FC_TX03,SKU000664,851,261,590,140,1400,2025-07-26
FC_TX03,SKU000955,563,157,406,84,840,2025-07-24
FC_TX03,SKU000965,1510,465,1045,210,2100,2025-07-26
FC_TX03,SKU000402,1544,475,1069,210,2100,2025-07-21
FC_TX03,SKU001255,856,250,606,140,1400,2025-07-26
FC_TX03,SKU000652,898,247,651,140,1400,2025-07-21
FC_TX03,SKU000482,1611,481,1130,210,2100,2025-07-24
FC_TX03,SKU000388,642,197,445,112,1120,2025-07-22
FC_TX03,SKU000780,609,198,411,112,1120,2025-07-27
FC_TX03,SKU001299,586,156,430,112,1120,2025-07-26
FC_TX03,SKU001691,890,270,620,140,1400,2025-07-25
FC_TX03,SKU000714,253,79,174,56,560,2025-07-21
FC_TX03,SKU001282,839,251,588,140,1400,2025-07-25
FC_TX03,SKU001336,588,190,398,112,1120,2025-07-25
FC_TX03,SKU001399,623,193,430,112,1120,2025-07-25
FC_TX03,SKU000997,236,57,179,56,560,2025-07-22
FC_TX03,SKU000226,234,62,172,56,560,2025-07-22
FC_TX03,SKU001387,870,265,605,140,1400,2025-07-27
FC_TX03,SKU001800,829,242,587,140,1400,2025-07-23
FC_TX03,SKU000855,632,190,442,112,1120,2025-07-27
FC_TX03,SKU000084,616,185,431,112,1120,2025-07-22
FC_TX03,SKU000736,540,187,353,84,840,2025-07-22
FC_TX03,SKU000536,1608,482,1126,210,2100,2025-07-21
FC_TX03,SKU000833,606,197,409,112,1120,2025-07-26
FC_TX03,SKU001841,540,171,369,84,840,2025-07-24
FC_TX03,SKU000829,839,251,588,140,1400,2025-07-27
FC_TX03,SKU000423,1560,449,1111,210,2100,2025-07-26
FC_TX03,SKU001951,1664,506,1158,210,2100,2025-07-24
FC_TX03,SKU001909,1573,489,1084,210,2100,2025-07-23
FC_TX03,SKU001874,1567,495,1072,210,2100,2025-07-25
FC_TX03,SKU001737,868,256,612,140,1400,2025-07-27
FC_TX03,SKU000185,820,247,573,140,1400,2025-07-23
FC_TX03,SKU001382,233,60,173,56,560,2025-07-21
FC_TX03,SKU001797,1535,463,1072,210,2100,2025-07-26
FC_TX03,SKU001645,855,261,594,140,1400,2025-07-24
FC_TX03,SKU001682,840,230,610,140,1400,2025-07-23
FC_TX03,SKU001472,786,239,547,140,1400,2025-07-23
FC_TX03,SKU000938,227,89,138,56,560,2025-07-25
FC_TX03,SKU001569,619,203,416,112,1120,2025-07-23
FC_TX03,SKU000268,250,83,167,56,560,2025-07-22
FC_TX03,SKU001607,262,87,175,56,560,2025-07-24
FC_TX03,SKU001641,500,166,334,84,840,2025-07-22
FC_TX03,SKU000488,537,173,364,84,840,2025-07-27
FC_TX03,SKU000183,607,168,439,112,1120,2025-07-25
FC_TX03,SKU001851,575,176,399,84,840,2025-07-22
FC_TX03,SKU001973,513,159,354,84,840,2025-07-27
FC_TX03,SKU000356,574,200,374,84,840,2025-07-25
FC_TX03,SKU000937,239,57,182,56,560,2025-07-22
FC_TX03,SKU001370,823,236,587,140,1400,2025-07-26
FC_TX03,SKU000512,594,177,417,84,840,2025-07-24
FC_TX03,SKU001143,259,86,173,56,560,2025-07-25
FC_TX03,SKU001926,603,162,441,112,1120,2025-07-27
FC_TX03,SKU000047,1635,510,1125,210,2100,2025-07-26
FC_TX03,SKU000100,511,164,347,84,840,2025-07-23
FC_TX03,SKU001862,271,83,188,56,560,2025-07-24
FC_TX03,SKU000987,1625,505,1120,210,2100,2025-07-24
FC_TX03,SKU001756,248,64,184,56,560,2025-07-24
FC_TX03,SKU000949,810,272,538,140,1400,2025-07-25
FC_TX03,SKU001694,241,57,184,56,560,2025-07-24
FC_TX03,SKU001127,634,177,457,112,1120,2025-07-23
FC_TX03,SKU000131,251,78,173,56,560,2025-07-23
FC_TX03,SKU000895,544,170,374,84,840,2025-07-21
FC_TX03,SKU000999,815,250,565,140,1400,2025-07-26
FC_TX03,SKU000392,624,186,438,112,1120,2025-07-27
FC_TX03,SKU001836,1572,484,1088,210,2100,2025-07-27
FC_TX03,SKU001307,823,231,592,140,1400,2025-07-22
FC_TX03,SKU000326,250,69,181,56,560,2025-07-25
FC_TX03,SKU001274,1540,490,1050,210,2100,2025-07-25
FC_TX03,SKU001312,824,245,579,140,1400,2025-07-27
FC_TX03,SKU000516,582,171,411,112,1120,2025-07-23
FC_TX03,SKU001239,558,179,379,84,840,2025-07-21
FC_TX03,SKU001298,262,92,170,56,560,2025-07-21
FC_TX03,SKU001837,645,186,459,112,1120,2025-07-23
FC_TX03,SKU000777,1643,482,1161,210,2100,2025-07-25
FC_TX03,SKU000081,543,154,389,84,840,2025-07-27
FC_TX03,SKU000500,234,65,169,56,560,2025-07-21
FC_TX03,SKU000215,820,248,572,140,1400,2025-07-27
FC_TX03,SKU001261,227,64,163,56,560,2025-07-26
FC_TX03,SKU000858,549,153,396,84,840,2025-07-25
FC_TX03,SKU000532,615,189,426,112,1120,2025-07-25
FC_TX03,SKU000933,532,150,382,84,840,2025-07-23
FC_TX03,SKU000298,626,205,421,112,1120,2025-07-24
FC_TX03,SKU001264,263,93,170,56,560,2025-07-24
FC_TX03,SKU000685,532,162,370,84,840,2025-07-22
FC_TX03,SKU000580,613,196,417,112,1120,2025-07-21
FC_TX03,SKU000896,879,269,610,140,1400,2025-07-27
FC_TX03,SKU000848,845,260,585,140,1400,2025-07-27
FC_TX03,SKU001021,570,181,389,84,840,2025-07-25
FC_TX03,SKU000484,811,249,562,140,1400,2025-07-23
FC_TX03,SKU001531,541,171,370,84,840,2025-07-24
FC_TX03,SKU001893,860,253,607,140,1400,2025-07-27
FC_TX03,SKU001714,667,200,467,112,1120,2025-07-27
FC_TX03,SKU000447,1524,463,1061,210,2100,2025-07-23
FC_TX03,SKU000005,833,281,552,140,1400,2025-07-22
FC_TX03,SKU000154,608,187,421,112,1120,2025-07-23
FC_TX03,SKU001971,559,156,403,84,840,2025-07-26
FC_TX03,SKU000880,590,172,418,84,840,2025-07-22
FC_TX03,SKU001678,235,71,164,56,560,2025-07-26
FC_TX03,SKU001520,561,161,400,84,840,2025-07-26
FC_TX03,SKU000841,279,74,205,56,560,2025-07-27
FC_TX03,SKU001667,575,180,395,112,1120,2025-07-23
FC_TX03,SKU000900,259,81,178,56,560,2025-07-24
FC_TX03,SKU000988,524,166,358,84,840,2025-07-21
FC_TX03,SKU000995,1585,486,1099,210,2100,2025-07-27
FC_TX03,SKU001200,612,164,448,112,1120,2025-07-23
FC_TX03,SKU000743,1580,492,1088,210,2100,2025-07-22
FC_TX03,SKU000386,518,149,369,84,840,2025-07-27
FC_TX03,SKU000669,232,57,175,56,560,2025-07-21
FC_TX03,SKU000784,562,171,391,84,840,2025-07-27
FC_TX03,SKU000273,264,84,180,56,560,2025-07-22
FC_TX03,SKU001060,1613,490,1123,210,2100,2025-07-25
FC_TX03,SKU000508,541,160,381,84,840,2025-07-26
FC_TX03,SKU001425,623,211,412,112,1120,2025-07-22
FC_TX03,SKU000956,849,233,616,140,1400,2025-07-26
FC_TX03,SKU000852,270,90,180,56,560,2025-07-26
FC_TX03,SKU000428,646,183,463,112,1120,2025-07-22
FC_TX03,SKU001560,1486,492,994,210,2100,2025-07-22
FC_TX03,SKU001244,1578,494,1084,210,2100,2025-07-21
FC_TX03,SKU000959,245,77,168,56,560,2025-07-23
FC_TX03,SKU001327,588,169,419,112,1120,2025-07-24
FC_TX03,SKU000724,548,160,388,84,840,2025-07-21
FC_TX03,SKU001653,1532,428,1104,210,2100,2025-07-23
FC_TX03,SKU001889,1660,493,1167,210,2100,2025-07-21
FC_TX03,SKU001657,1577,459,1118,210,2100,2025-07-26
FC_TX03,SKU001647,527,154,373,84,840,2025-07-23
FC_TX03,SKU001162,613,183,430,112,1120,2025-07-26
FC_TX03,SKU001518,831,250,581,140,1400,2025-07-21
FC_TX03,SKU000822,258,92,166,56,560,2025-07-27
FC_TX03,SKU000048,260,77,183,56,560,2025-07-24
FC_TX03,SKU001041,608,167,441,112,1120,2025-07-24
FC_TX03,SKU001921,259,83,176,56,560,2025-07-26
FC_TX03,SKU001644,1457,444,1013,210,2100,2025-07-24
FC_TX03,SKU001443,836,274,562,140,1400,2025-07-22
FC_TX03,SKU001341,891,262,629,140,1400,2025-07-26
FC_TX03,SKU000471,262,99,163,56,560,2025-07-21
FC_TX03,SKU001459,628,175,453,112,1120,2025-07-27
FC_TX03,SKU001245,608,171,437,112,1120,2025-07-24
FC_TX03,SKU001519,524,168,356,84,840,2025-07-27
FC_TX03,SKU000292,545,160,385,84,840,2025-07-21
FC_TX03,SKU000737,1572,455,1117,210,2100,2025-07-21
FC_TX03,SKU001624,1559,487,1072,210,2100,2025-07-21
FC_TX03,SKU001865,843,256,587,140,1400,2025-07-21
FC_TX03,SKU001061,561,165,396,84,840,2025-07-21
FC_TX03,SKU001155,590,170,420,84,840,2025-07-22
FC_TX03,SKU001665,554,179,375,84,840,2025-07-23
FC_TX03,SKU001686,601,174,427,112,1120,2025-07-23
FC_TX03,SKU001766,529,144,385,84,840,2025-07-21
FC_TX03,SKU000151,275,80,195,56,560,2025-07-23
FC_TX03,SKU001810,613,177,436,112,1120,2025-07-22
FC_TX03,SKU001853,525,166,359,84,840,2025-07-24
FC_TX03,SKU000656,1618,513,1105,210,2100,2025-07-27
FC_TX03,SKU001431,558,183,375,84,840,2025-07-21
FC_TX03,SKU001828,850,234,616,140,1400,2025-07-24
FC_TX03,SKU000926,258,83,175,56,560,2025-07-21
FC_TX03,SKU000765,595,214,381,112,1120,2025-07-21
FC_TX03,SKU000205,1503,419,1084,210,2100,2025-07-22
FC_TX03,SKU001549,618,187,431,112,1120,2025-07-24
FC_TX03,SKU000729,816,240,576,140,1400,2025-07-27
FC_TX03,SKU000553,804,239,565,140,1400,2025-07-22
FC_TX03,SKU000269,263,75,188,56,560,2025-07-22
FC_TX03,SKU001305,1529,460,1069,210,2100,2025-07-25
FC_TX03,SKU000910,241,74,167,56,560,2025-07-27
FC_TX03,SKU001488,810,269,541,140,1400,2025-07-21
FC_TX03,SKU001543,551,165,386,84,840,2025-07-22
FC_TX03,SKU001709,239,73,166,56,560,2025-07-26
FC_TX03,SKU001140,895,254,641,140,1400,2025-07-26
FC_TX03,SKU001357,578,185,393,112,1120,2025-07-22
FC_TX03,SKU001925,554,170,384,84,840,2025-07-24
FC_TX03,SKU001910,1629,501,1128,210,2100,2025-07-24
FC_TX03,SKU000274,511,152,359,84,840,2025-07-24
FC_TX03,SKU000963,856,270,586,140,1400,2025-07-26
FC_TX03,SKU001796,670,205,465,112,1120,2025-07-26
FC_TX03,SKU001759,624,167,457,112,1120,2025-07-24
FC_TX03,SKU001513,1594,501,1093,210,2100,2025-07-24
FC_TX03,SKU000098,1570,479,1091,210,2100,2025-07-25
FC_TX03,SKU001205,1598,447,1151,210,2100,2025-07-21
FC_TX03,SKU001365,1621,467,1154,210,2100,2025-07-27
FC_TX03,SKU000031,245,72,173,56,560,2025-07-24
FC_TX03,SKU001340,866,253,613,140,1400,2025-07-26
FC_TX03,SKU001474,1609,517,1092,210,2100,2025-07-27
FC_TX03,SKU000513,858,256,602,140,1400,2025-07-27
FC_TX03,SKU001122,593,175,418,112,1120,2025-07-22
FC_TX03,SKU001385,618,202,416,112,1120,2025-07-25
FC_TX03,SKU001699,245,83,162,56,560,2025-07-27
FC_TX03,SKU001708,825,239,586,140,1400,2025-07-23
FC_TX03,SKU001890,632,148,484,112,1120,2025-07-23
FC_TX03,SKU000811,580,182,398,84,840,2025-07-25
FC_TX03,SKU000758,540,151,389,84,840,2025-07-24
FC_TX03,SKU001002,805,243,562,140,1400,2025-07-26
FC_TX03,SKU001806,834,256,578,140,1400,2025-07-24
FC_TX03,SKU000424,592,157,435,112,1120,2025-07-26
FC_TX03,SKU000986,1561,459,1102,210,2100,2025-07-21
FC_TX03,SKU000519,236,70,166,56,560,2025-07-22
FC_TX03,SKU001320,849,271,578,140,1400,2025-07-24
FC_TX03,SKU001099,1632,476,1156,210,2100,2025-07-27
FC_TX03,SKU000228,580,159,421,112,1120,2025-07-26
FC_TX03,SKU000875,263,74,189,56,560,2025-07-22
FC_TX03,SKU001413,932,275,657,140,1400,2025-07-23
FC_TX03,SKU001313,1607,519,1088,210,2100,2025-07-21
FC_TX03,SKU001990,609,181,428,112,1120,2025-07-27
FC_TX03,SKU001156,830,248,582,140,1400,2025-07-23
FC_TX03,SKU001911,553,164,389,84,840,2025-07-23
FC_TX03,SKU000396,255,79,176,56,560,2025-07-27
FC_TX03,SKU000659,261,91,170,56,560,2025-07-22
FC_TX03,SKU001696,234,87,147,56,560,2025-07-25
FC_TX03,SKU000455,544,172,372,84,840,2025-07-25
FC_TX03,SKU001034,844,249,595,140,1400,2025-07-26
FC_TX03,SKU001593,832,243,589,140,1400,2025-07-22
FC_TX03,SKU000570,1572,459,1113,210,2100,2025-07-27
FC_TX03,SKU000642,531,152,379,84,840,2025-07-26
FC_TX03,SKU001669,578,180,398,84,840,2025-07-27
FC_TX03,SKU000496,547,144,403,84,840,2025-07-25
FC_TX03,SKU000209,570,183,387,84,840,2025-07-27
FC_TX03,SKU001422,610,189,421,112,1120,2025-07-21
FC_TX03,SKU001359,556,157,399,84,840,2025-07-22
FC_TX03,SKU000772,270,80,190,56,560,2025-07-25
FC_TX03,SKU000691,541,175,366,84,840,2025-07-25
FC_TX03,SKU000147,255,72,183,56,560,2025-07-25
FC_TX03,SKU001344,1566,476,1090,210,2100,2025-07-22
FC_TX03,SKU001250,547,161,386,84,840,2025-07-25
FC_TX03,SKU001004,526,168,358,84,840,2025-07-27
FC_TX03,SKU000328,877,256,621,140,1400,2025-07-27
FC_TX03,SKU001527,230,66,164,56,560,2025-07-22
FC_TX03,SKU000323,535,170,365,84,840,2025-07-26
FC_TX03,SKU001166,647,175,472,112,1120,2025-07-26
FC_TX03,SKU000139,1590,505,1085,210,2100,2025-07-21
FC_TX03,SKU001221,617,199,418,112,1120,2025-07-27
FC_TX03,SKU001637,617,173,444,112,1120,2025-07-26
FC_TX03,SKU000166,642,186,456,112,1120,2025-07-25
FC_TX03,SKU000316,858,257,601,140,1400,2025-07-25
FC_TX03,SKU000259,1562,473,1089,210,2100,2025-07-26
FC_TX03,SKU000647,255,77,178,56,560,2025-07-24
FC_TX03,SKU001411,1541,489,1052,210,2100,2025-07-27
FC_TX03,SKU001117,653,196,457,112,1120,2025-07-26
FC_TX03,SKU000663,239,70,169,56,560,2025-07-25
FC_TX03,SKU001032,877,275,602,140,1400,2025-07-26
FC_TX03,SKU001875,655,198,457,112,1120,2025-07-26
FC_TX03,SKU000367,610,170,440,112,1120,2025-07-24
FC_TX03,SKU000457,810,246,564,140,1400,2025-07-26
FC_TX03,SKU000574,1580,432,1148,210,2100,2025-07-26
FC_TX03,SKU000978,509,158,351,84,840,2025-07-26
FC_TX03,SKU001610,238,77,161,56,560,2025-07-26
FC_TX03,SKU001870,260,70,190,56,560,2025-07-23
FC_TX03,SKU000981,572,177,395,84,840,2025-07-27
FC_TX03,SKU001879,841,207,634,140,1400,2025-07-21
FC_TX03,SKU001680,574,172,402,84,840,2025-07-21
FC_TX03,SKU001886,547,136,411,84,840,2025-07-26
FC_TX03,SKU001169,625,183,442,112,1120,2025-07-24
FC_TX03,SKU001575,231,54,177,56,560,2025-07-21
FC_TX03,SKU001270,1554,447,1107,210,2100,2025-07-25
FC_TX03,SKU000537,623,196,427,112,1120,2025-07-27
FC_TX03,SKU001927,586,157,429,84,840,2025-07-22
FC_TX03,SKU000385,649,174,475,112,1120,2025-07-23
FC_TX03,SKU000213,254,74,180,56,560,2025-07-24
FC_TX03,SKU001918,847,254,593,140,1400,2025-07-26
FC_TX03,SKU001668,243,79,164,56,560,2025-07-23
FC_TX03,SKU001817,537,167,370,84,840,2025-07-23
FC_TX03,SKU000344,879,299,580,140,1400,2025-07-27
FC_TX03,SKU001438,827,241,586,140,1400,2025-07-23
FC_TX03,SKU001867,609,155,454,112,1120,2025-07-24
FC_TX03,SKU001059,1562,455,1107,210,2100,2025-07-26
FC_TX03,SKU000466,857,248,609,140,1400,2025-07-24
FC_TX03,SKU001081,1600,454,1146,210,2100,2025-07-22
FC_TX03,SKU000361,624,190,434,112,1120,2025-07-23
FC_TX03,SKU001716,827,245,582,140,1400,2025-07-26
FC_TX03,SKU000661,232,69,163,56,560,2025-07-27
FC_TX03,SKU001600,880,232,648,140,1400,2025-07-27
FC_TX03,SKU001035,858,242,616,140,1400,2025-07-27
FC_TX03,SKU000623,894,267,627,140,1400,2025-07-25
FC_TX03,SKU001197,269,83,186,56,560,2025-07-25
FC_TX03,SKU000699,271,78,193,56,560,2025-07-26
FC_TX03,SKU001613,634,170,464,112,1120,2025-07-21
FC_TX03,SKU001284,800,241,559,140,1400,2025-07-26
FC_TX03,SKU001338,1654,518,1136,210,2100,2025-07-23
FC_TX03,SKU001222,256,75,181,56,560,2025-07-27
FC_TX03,SKU001271,831,241,590,140,1400,2025-07-25
FC_TX03,SKU001183,567,156,411,84,840,2025-07-24
FC_TX03,SKU001892,242,63,179,56,560,2025-07-25
FC_TX03,SKU000468,796,257,539,140,1400,2025-07-21
FC_TX03,SKU001252,598,174,424,112,1120,2025-07-25
FC_TX03,SKU000275,574,179,395,112,1120,2025-07-22
FC_TX03,SKU001190,260,77,183,56,560,2025-07-21
FC_TX03,SKU000403,252,70,182,56,560,2025-07-26
FC_TX03,SKU000055,266,69,197,56,560,2025-07-23
FC_TX03,SKU000786,614,193,421,112,1120,2025-07-22
FC_TX03,SKU001822,1520,445,1075,210,2100,2025-07-21
FC_TX03,SKU001334,254,108,146,56,560,2025-07-24
FC_TX03,SKU001974,502,134,368,84,840,2025-07-23
FC_TX03,SKU000016,598,192,406,112,1120,2025-07-21
FC_TX03,SKU001022,1588,475,1113,210,2100,2025-07-25
FC_TX03,SKU000565,825,262,563,140,1400,2025-07-27
FC_TX03,SKU001078,863,246,617,140,1400,2025-07-26
FC_TX03,SKU000225,904,302,602,140,1400,2025-07-27
FC_TX03,SKU001133,603,189,414,112,1120,2025-07-23
FC_TX03,SKU001111,845,269,576,140,1400,2025-07-27
FC_TX03,SKU001567,598,176,422,112,1120,2025-07-27
FC_TX03,SKU001027,1640,515,1125,210,2100,2025-07-21
FC_TX03,SKU000146,1628,495,1133,210,2100,2025-07-22
FC_TX03,SKU001176,1598,529,1069,210,2100,2025-07-22
FC_TX03,SKU001807,520,155,365,84,840,2025-07-25
FC_TX03,SKU000062,236,63,173,56,560,2025-07-25
FC_TX03,SKU001283,814,233,581,140,1400,2025-07-27
FC_TX03,SKU001931,535,170,365,84,840,2025-07-25
FC_TX03,SKU001784,635,168,467,112,1120,2025-07-23
FC_TX03,SKU000846,792,229,563,140,1400,2025-07-21
FC_TX03,SKU001069,869,255,614,140,1400,2025-07-27
FC_TX03,SKU001987,261,72,189,56,560,2025-07-27
FC_TX03,SKU001277,820,227,593,140,1400,2025-07-27
FC_TX03,SKU000625,1542,467,1075,210,2100,2025-07-23
FC_TX03,SKU001533,596,173,423,112,1120,2025-07-27
FC_TX03,SKU001717,274,78,196,56,560,2025-07-21
FC_TX03,SKU001948,648,205,443,112,1120,2025-07-26
FC_TX03,SKU001192,851,261,590,140,1400,2025-07-21
FC_TX03,SKU000931,599,182,417,112,1120,2025-07-21
FC_TX03,SKU000809,615,188,427,112,1120,2025-07-26
FC_TX03,SKU000136,243,72,171,56,560,2025-07-22
FC_TX03,SKU001666,1656,477,1179,210,2100,2025-07-23
FC_TX03,SKU000058,595,175,420,112,1120,2025-07-22
FC_TX03,SKU000283,646,203,443,112,1120,2025-07-25
FC_TX03,SKU000869,532,136,396,84,840,2025-07-24
FC_TX03,SKU000009,555,192,363,84,840,2025-07-23
FC_TX03,SKU000222,817,227,590,140,1400,2025-07-24
FC_TX03,SKU001684,1582,459,1123,210,2100,2025-07-24
FC_TX03,SKU000556,566,162,404,112,1120,2025-07-21
FC_TX03,SKU001846,834,264,570,140,1400,2025-07-27
FC_TX03,SKU001541,1599,492,1107,210,2100,2025-07-26
FC_TX03,SKU000020,561,183,378,84,840,2025-07-24
FC_TX03,SKU001823,265,71,194,56,560,2025-07-26
FC_TX03,SKU001887,276,88,188,56,560,2025-07-21
FC_TX03,SKU000491,563,150,413,84,840,2025-07-27
FC_TX03,SKU001234,622,208,414,112,1120,2025-07-24
FC_TX03,SKU000741,258,60,198,56,560,2025-07-27
FC_TX03,SKU001079,261,76,185,56,560,2025-07-25
FC_TX03,SKU001897,267,85,182,56,560,2025-07-26
FC_TX03,SKU001092,1519,450,1069,210,2100,2025-07-22
FC_TX03,SKU001306,619,191,428,112,1120,2025-07-22
FC_TX03,SKU001852,922,284,638,140,1400,2025-07-26
FC_TX03,SKU001010,259,83,176,56,560,2025-07-22
FC_TX03,SKU001944,1547,512,1035,210,2100,2025-07-24
FC_TX03,SKU000756,502,151,351,84,840,2025-07-27
FC_TX03,SKU001151,618,172,446,112,1120,2025-07-24
FC_TX03,SKU001339,857,275,582,140,1400,2025-07-25
FC_TX03,SKU001415,260,79,181,56,560,2025-07-23
FC_TX03,SKU000791,603,171,432,112,1120,2025-07-24
FC_TX03,SKU001585,1582,472,1110,210,2100,2025-07-23
FC_TX03,SKU001304,256,73,183,56,560,2025-07-26
FC_TX03,SKU000026,620,181,439,112,1120,2025-07-25
FC_TX03,SKU000277,857,278,579,140,1400,2025-07-21
FC_TX03,SKU001813,849,260,589,140,1400,2025-07-24
FC_TX03,SKU001240,1593,468,1125,210,2100,2025-07-22
FC_TX03,SKU001634,1569,486,1083,210,2100,2025-07-26
FC_TX03,SKU001294,621,178,443,112,1120,2025-07-22
FC_TX03,SKU001131,851,262,589,140,1400,2025-07-25
FC_TX03,SKU001262,258,73,185,56,560,2025-07-26
FC_TX03,SKU001071,248,79,169,56,560,2025-07-23
FC_TX03,SKU000818,628,184,444,112,1120,2025-07-24
FC_TX03,SKU001994,795,247,548,140,1400,2025-07-21
FC_TX03,SKU000409,585,151,434,112,1120,2025-07-27
FC_TX03,SKU001995,493,147,346,84,840,2025-07-25
FC_TX03,SKU000168,860,247,613,140,1400,2025-07-22
FC_GA04,SKU001072,1567,471,1096,210,2100,2025-07-27
FC_GA04,SKU001082,261,91,170,56,560,2025-07-26
FC_GA04,SKU001917,1574,465,1109,210,2100,2025-07-21
FC_GA04,SKU000962,560,144,416,84,840,2025-07-22
FC_GA04,SKU001718,567,171,396,84,840,2025-07-23
FC_GA04,SKU001479,597,161,436,112,1120,2025-07-22
FC_GA04,SKU000431,798,236,562,140,1400,2025-07-22
FC_GA04,SKU000542,595,187,408,112,1120,2025-07-25
FC_GA04,SKU001638,254,60,194,56,560,2025-07-25
FC_GA04,SKU000134,1609,469,1140,210,2100,2025-07-26
FC_GA04,SKU001618,886,252,634,140,1400,2025-07-26
FC_GA04,SKU000969,254,83,171,56,560,2025-07-21
FC_GA04,SKU001243,500,143,357,84,840,2025-07-21
FC_GA04,SKU000500,245,67,178,56,560,2025-07-21
FC_GA04,SKU001640,569,152,417,112,1120,2025-07-27
FC_GA04,SKU000688,917,266,651,140,1400,2025-07-26
FC_GA04,SKU001464,1542,460,1082,210,2100,2025-07-22
FC_GA04,SKU001713,613,185,428,112,1120,2025-07-26
FC_GA04,SKU000142,232,63,169,56,560,2025-07-22
FC_GA04,SKU000396,260,80,180,56,560,2025-07-21
FC_GA04,SKU001028,843,273,570,140,1400,2025-07-24
FC_GA04,SKU001381,652,201,451,112,1120,2025-07-25
FC_GA04,SKU000749,257,70,187,56,560,2025-07-27
FC_GA04,SKU001419,253,90,163,56,560,2025-07-22
FC_GA04,SKU001402,567,167,400,84,840,2025-07-21
FC_GA04,SKU001662,1562,443,1119,210,2100,2025-07-26
FC_GA04,SKU001581,899,298,601,140,1400,2025-07-21
FC_GA04,SKU001907,1596,498,1098,210,2100,2025-07-27
FC_GA04,SKU001784,587,158,429,112,1120,2025-07-27
FC_GA04,SKU001043,262,68,194,56,560,2025-07-21
FC_GA04,SKU001889,1611,465,1146,210,2100,2025-07-22
FC_GA04,SKU000852,273,106,167,56,560,2025-07-23
FC_GA04,SKU001491,226,71,155,56,560,2025-07-21
FC_GA04,SKU001436,612,167,445,112,1120,2025-07-23
FC_GA04,SKU001284,826,258,568,140,1400,2025-07-22
FC_GA04,SKU000642,543,171,372,84,840,2025-07-27
FC_GA04,SKU000261,610,190,420,112,1120,2025-07-25
FC_GA04,SKU000369,814,214,600,140,1400,2025-07-21
FC_GA04,SKU001199,270,76,194,56,560,2025-07-24
FC_GA04,SKU000566,1553,481,1072,210,2100,2025-07-21
FC_GA04,SKU001985,555,149,406,84,840,2025-07-23
FC_GA04,SKU000287,519,174,345,84,840,2025-07-24
FC_GA04,SKU001353,798,246,552,140,1400,2025-07-25
FC_GA04,SKU001021,529,163,366,84,840,2025-07-22
FC_GA04,SKU001016,520,155,365,84,840,2025-07-22
FC_GA04,SKU001983,1572,457,1115,210,2100,2025-07-26
FC_GA04,SKU000587,826,253,573,140,1400,2025-07-23
FC_GA04,SKU001644,1579,474,1105,210,2100,2025-07-24
FC_GA04,SKU001458,247,81,166,56,560,2025-07-22
FC_GA04,SKU000352,528,174,354,84,840,2025-07-26
FC_GA04,SKU000960,548,176,372,84,840,2025-07-24
FC_GA04,SKU001246,1567,469,1098,210,2100,2025-07-22
FC_GA04,SKU001091,1538,496,1042,210,2100,2025-07-24
FC_GA04,SKU000081,546,183,363,84,840,2025-07-25
FC_GA04,SKU000927,619,173,446,84,840,2025-07-25
FC_GA04,SKU000954,817,223,594,140,1400,2025-07-25
FC_GA04,SKU000555,236,70,166,56,560,2025-07-24
FC_GA04,SKU000160,260,81,179,56,560,2025-07-24
FC_GA04,SKU000037,628,187,441,112,1120,2025-07-22
FC_GA04,SKU000053,558,164,394,84,840,2025-07-23
FC_GA04,SKU001195,550,164,386,84,840,2025-07-24
FC_GA04,SKU000438,551,158,393,84,840,2025-07-23
FC_GA04,SKU000347,532,154,378,84,840,2025-07-25
FC_GA04,SKU000579,577,160,417,112,1120,2025-07-25
FC_GA04,SKU000039,626,200,426,112,1120,2025-07-21
FC_GA04,SKU000692,637,177,460,112,1120,2025-07-26
FC_GA04,SKU001315,852,260,592,140,1400,2025-07-24
FC_GA04,SKU001413,819,236,583,140,1400,2025-07-22
FC_GA04,SKU000802,555,166,389,84,840,2025-07-25
FC_GA04,SKU000798,562,187,375,84,840,2025-07-25
FC_GA04,SKU000060,528,159,369,84,840,2025-07-25
FC_GA04,SKU001827,848,254,594,140,1400,2025-07-23
FC_GA04,SKU001126,560,164,396,84,840,2025-07-21
FC_GA04,SKU001367,569,174,395,84,840,2025-07-23
FC_GA04,SKU000409,612,204,408,112,1120,2025-07-25
FC_GA04,SKU001496,262,87,175,56,560,2025-07-23
FC_GA04,SKU001978,791,255,536,140,1400,2025-07-23
FC_GA04,SKU001434,267,75,192,56,560,2025-07-27
FC_GA04,SKU000774,1555,471,1084,210,2100,2025-07-26
FC_GA04,SKU000525,616,191,425,112,1120,2025-07-24
FC_GA04,SKU001778,280,89,191,56,560,2025-07-27
FC_GA04,SKU000186,623,149,474,112,1120,2025-07-25
FC_GA04,SKU001206,571,174,397,84,840,2025-07-25
FC_GA04,SKU001997,559,182,377,84,840,2025-07-21
FC_GA04,SKU001059,1645,546,1099,210,2100,2025-07-21
FC_GA04,SKU001366,1611,505,1106,210,2100,2025-07-26
FC_GA04,SKU001877,794,219,575,140,1400,2025-07-24
FC_GA04,SKU001120,264,70,194,56,560,2025-07-24
FC_GA04,SKU001777,539,157,382,84,840,2025-07-23
FC_GA04,SKU000709,543,166,377,84,840,2025-07-24
FC_GA04,SKU001333,1560,469,1091,210,2100,2025-07-23
FC_GA04,SKU001387,825,253,572,140,1400,2025-07-24
FC_GA04,SKU000882,540,169,371,84,840,2025-07-21
FC_GA04,SKU001180,819,238,581,140,1400,2025-07-21
FC_GA04,SKU001369,848,254,594,140,1400,2025-07-27
FC_GA04,SKU000562,864,237,627,140,1400,2025-07-22
FC_GA04,SKU000222,846,264,582,140,1400,2025-07-26
FC_GA04,SKU000945,610,190,420,112,1120,2025-07-25
FC_GA04,SKU001154,1561,480,1081,210,2100,2025-07-23
FC_GA04,SKU000020,517,148,369,84,840,2025-07-25
FC_GA04,SKU001767,269,83,186,56,560,2025-07-24
FC_GA04,SKU001250,514,149,365,84,840,2025-07-26
FC_GA04,SKU000898,589,178,411,112,1120,2025-07-21
FC_GA04,SKU000870,1611,502,1109,210,2100,2025-07-25
FC_GA04,SKU001462,1577,477,1100,210,2100,2025-07-26
FC_GA04,SKU000612,570,155,415,84,840,2025-07-26
FC_GA04,SKU001337,586,172,414,112,1120,2025-07-26
FC_GA04,SKU000299,630,181,449,112,1120,2025-07-26
FC_GA04,SKU000052,250,70,180,56,560,2025-07-27
FC_GA04,SKU001537,854,257,597,140,1400,2025-07-22
FC_GA04,SKU000327,829,219,610,140,1400,2025-07-23
FC_GA04,SKU000967,791,235,556,140,1400,2025-07-24
FC_GA04,SKU001405,831,241,590,140,1400,2025-07-21
FC_GA04,SKU001876,542,194,348,84,840,2025-07-24
FC_GA04,SKU001892,235,70,165,56,560,2025-07-25
FC_GA04,SKU001497,619,180,439,112,1120,2025-07-22
FC_GA04,SKU000171,1553,476,1077,210,2100,2025-07-24
FC_GA04,SKU001967,588,155,433,112,1120,2025-07-24
FC_GA04,SKU001575,236,65,171,56,560,2025-07-27
FC_GA04,SKU000803,655,196,459,112,1120,2025-07-26
FC_GA04,SKU000567,492,158,334,84,840,2025-07-24
FC_GA04,SKU000372,564,178,386,84,840,2025-07-21
FC_GA04,SKU001880,533,172,361,84,840,2025-07-24
FC_GA04,SKU000280,507,150,357,84,840,2025-07-23
FC_GA04,SKU001929,539,181,358,84,840,2025-07-25
FC_GA04,SKU001029,652,197,455,112,1120,2025-07-21
FC_GA04,SKU001394,1619,483,1136,210,2100,2025-07-27
FC_GA04,SKU001396,612,199,413,112,1120,2025-07-21
FC_GA04,SKU001974,535,146,389,84,840,2025-07-24
FC_GA04,SKU001729,241,73,168,56,560,2025-07-23
FC_GA04,SKU000165,274,82,192,56,560,2025-07-25
FC_GA04,SKU001814,836,251,585,140,1400,2025-07-21
FC_GA04,SKU000132,248,70,178,56,560,2025-07-27
FC_GA04,SKU000904,249,82,167,56,560,2025-07-24
FC_GA04,SKU001521,512,152,360,84,840,2025-07-21
FC_GA04,SKU000125,1627,494,1133,210,2100,2025-07-25
FC_GA04,SKU000671,1566,481,1085,210,2100,2025-07-23
FC_GA04,SKU000474,893,259,634,140,1400,2025-07-22
FC_GA04,SKU000839,246,70,176,56,560,2025-07-24
FC_GA04,SKU000208,253,81,172,56,560,2025-07-25
FC_GA04,SKU000840,881,280,601,140,1400,2025-07-25
FC_GA04,SKU001766,559,187,372,84,840,2025-07-22
FC_GA04,SKU001738,1551,469,1082,210,2100,2025-07-23
FC_GA04,SKU001602,827,259,568,140,1400,2025-07-22
FC_GA04,SKU001675,826,273,553,140,1400,2025-07-26
FC_GA04,SKU001300,625,173,452,112,1120,2025-07-22
FC_GA04,SKU000532,659,199,460,112,1120,2025-07-21
FC_GA04,SKU000558,525,165,360,84,840,2025-07-21
FC_GA04,SKU001379,549,188,361,84,840,2025-07-24
FC_GA04,SKU000724,613,178,435,84,840,2025-07-22
FC_GA04,SKU000104,590,202,388,112,1120,2025-07-23
FC_GA04,SKU000120,618,211,407,112,1120,2025-07-26
FC_GA04,SKU000377,546,146,400,84,840,2025-07-24
FC_GA04,SKU000931,649,201,448,112,1120,2025-07-23
FC_GA04,SKU001358,1561,440,1121,210,2100,2025-07-27
FC_GA04,SKU001841,556,157,399,84,840,2025-07-24
FC_GA04,SKU000441,233,72,161,56,560,2025-07-26
FC_GA04,SKU000603,549,175,374,84,840,2025-07-21
FC_GA04,SKU001269,1562,463,1099,210,2100,2025-07-27
FC_GA04,SKU000752,842,254,588,140,1400,2025-07-22
FC_GA04,SKU000786,602,187,415,112,1120,2025-07-27
FC_GA04,SKU001156,817,263,554,140,1400,2025-07-22
FC_GA04,SKU000864,625,184,441,84,840,2025-07-21
FC_GA04,SKU001273,531,148,383,84,840,2025-07-25
FC_GA04,SKU001242,871,238,633,140,1400,2025-07-21
FC_GA04,SKU001267,885,237,648,140,1400,2025-07-22
FC_GA04,SKU001277,878,283,595,140,1400,2025-07-25
FC_GA04,SKU000634,1556,464,1092,210,2100,2025-07-23
FC_GA04,SKU001628,607,180,427,112,1120,2025-07-23
FC_GA04,SKU000800,582,158,424,84,840,2025-07-27
FC_GA04,SKU000543,863,242,621,140,1400,2025-07-22
FC_GA04,SKU001501,1608,482,1126,210,2100,2025-07-23
FC_GA04,SKU001786,241,74,167,56,560,2025-07-25
FC_GA04,SKU000226,250,94,156,56,560,2025-07-22
FC_GA04,SKU001562,605,216,389,112,1120,2025-07-24
FC_GA04,SKU000244,1570,480,1090,210,2100,2025-07-23
FC_GA04,SKU001216,648,203,445,112,1120,2025-07-22
FC_GA04,SKU000048,278,89,189,56,560,2025-07-27
FC_GA04,SKU000406,562,180,382,84,840,2025-07-26
FC_GA04,SKU000300,1596,482,1114,210,2100,2025-07-25
FC_GA04,SKU001531,504,152,352,84,840,2025-07-26
FC_GA04,SKU000670,557,147,410,84,840,2025-07-22
FC_GA04,SKU001996,549,167,382,84,840,2025-07-22
FC_GA04,SKU000613,274,76,198,56,560,2025-07-23
FC_GA04,SKU000894,586,177,409,112,1120,2025-07-24
FC_GA04,SKU001251,248,94,154,56,560,2025-07-27
FC_GA04,SKU000553,873,251,622,140,1400,2025-07-22
FC_GA04,SKU000892,828,247,581,140,1400,2025-07-22
FC_GA04,SKU001924,866,246,620,140,1400,2025-07-27
FC_GA04,SKU001153,605,198,407,84,840,2025-07-23
FC_GA04,SKU001737,840,253,587,140,1400,2025-07-21
FC_GA04,SKU001112,269,92,177,56,560,2025-07-21
FC_GA04,SKU000064,643,208,435,112,1120,2025-07-26
FC_GA04,SKU000453,1632,490,1142,210,2100,2025-07-23
FC_GA04,SKU000157,527,153,374,84,840,2025-07-23
FC_GA04,SKU000503,259,75,184,56,560,2025-07-27
FC_GA04,SKU001578,636,185,451,112,1120,2025-07-22
FC_GA04,SKU000884,620,200,420,112,1120,2025-07-27
FC_GA04,SKU000203,530,155,375,84,840,2025-07-23
FC_GA04,SKU001647,569,156,413,84,840,2025-07-23
FC_GA04,SKU000297,619,207,412,112,1120,2025-07-24
FC_GA04,SKU000233,621,168,453,112,1120,2025-07-25
FC_GA04,SKU000224,264,75,189,56,560,2025-07-22
FC_GA04,SKU001936,1569,469,1100,210,2100,2025-07-26
FC_GA04,SKU000510,1607,486,1121,210,2100,2025-07-26
FC_GA04,SKU000174,568,175,393,84,840,2025-07-27
FC_GA04,SKU001032,833,264,569,140,1400,2025-07-22
FC_GA04,SKU000661,232,66,166,56,560,2025-07-26
FC_GA04,SKU001636,612,169,443,112,1120,2025-07-26
FC_GA04,SKU000185,829,255,574,140,1400,2025-07-25
FC_GA04,SKU000130,226,78,148,56,560,2025-07-22
FC_GA04,SKU001060,1621,515,1106,210,2100,2025-07-27
FC_GA04,SKU000722,590,219,371,112,1120,2025-07-26
FC_GA04,SKU000850,1492,447,1045,210,2100,2025-07-21
FC_GA04,SKU000753,830,266,564,140,1400,2025-07-26
FC_GA04,SKU001463,591,181,410,112,1120,2025-07-22
FC_GA04,SKU000004,1624,474,1150,210,2100,2025-07-22
FC_GA04,SKU000499,625,178,447,112,1120,2025-07-26
FC_GA04,SKU001730,260,82,178,56,560,2025-07-22
FC_GA04,SKU001529,592,181,411,112,1120,2025-07-22
FC_GA04,SKU000832,519,180,339,84,840,2025-07-23
FC_GA04,SKU000961,248,69,179,56,560,2025-07-23
FC_GA04,SKU001588,526,147,379,84,840,2025-07-24
FC_GA04,SKU000742,259,59,200,56,560,2025-07-27
FC_GA04,SKU001308,557,142,415,84,840,2025-07-22
FC_GA04,SKU000887,284,78,206,56,560,2025-07-24
FC_GA04,SKU001668,261,89,172,56,560,2025-07-23
FC_GA04,SKU001260,841,239,602,140,1400,2025-07-25
FC_GA04,SKU000463,246,75,171,56,560,2025-07-23
FC_GA04,SKU001956,1572,474,1098,210,2100,2025-07-21
FC_GA04,SKU001239,520,165,355,84,840,2025-07-25
FC_GA04,SKU000934,530,151,379,84,840,2025-07-24
FC_GA04,SKU000077,1595,527,1068,210,2100,2025-07-25
FC_GA04,SKU000419,615,179,436,112,1120,2025-07-26
FC_GA04,SKU000810,667,232,435,112,1120,2025-07-23
FC_GA04,SKU000576,631,207,424,112,1120,2025-07-27
FC_GA04,SKU001799,1573,475,1098,210,2100,2025-07-26
FC_GA04,SKU000511,284,101,183,56,560,2025-07-22
FC_GA04,SKU001343,546,156,390,84,840,2025-07-24
FC_GA04,SKU001847,571,194,377,84,840,2025-07-25
FC_GA04,SKU000147,260,97,163,56,560,2025-07-21
FC_GA04,SKU001361,846,217,629,140,1400,2025-07-24
FC_GA04,SKU000526,263,84,179,56,560,2025-07-21
FC_GA04,SKU001833,611,164,447,112,1120,2025-07-27
FC_GA04,SKU000029,1550,486,1064,210,2100,2025-07-24
FC_GA04,SKU000102,239,62,177,56,560,2025-07-22
FC_GA04,SKU000929,1621,486,1135,210,2100,2025-07-24
FC_GA04,SKU000589,632,183,449,112,1120,2025-07-26
FC_GA04,SKU001702,600,187,413,112,1120,2025-07-27
FC_GA04,SKU000036,851,282,569,140,1400,2025-07-22
FC_GA04,SKU000153,601,184,417,112,1120,2025-07-26
FC_GA04,SKU001342,524,155,369,84,840,2025-07-27
FC_GA04,SKU000329,566,171,395,84,840,2025-07-23
FC_GA04,SKU000560,228,61,167,56,560,2025-07-27
FC_GA04,SKU001534,1545,417,1128,210,2100,2025-07-27
FC_GA04,SKU000795,766,206,560,140,1400,2025-07-23
FC_GA04,SKU000902,251,74,177,56,560,2025-07-21
FC_GA04,SKU001613,610,180,430,112,1120,2025-07-27
FC_GA04,SKU000030,566,171,395,112,1120,2025-07-22
FC_GA04,SKU000908,594,181,413,84,840,2025-07-24
FC_GA04,SKU000641,612,164,448,112,1120,2025-07-24
FC_GA04,SKU001130,1538,430,1108,210,2100,2025-07-25
FC_GA04,SKU001094,597,219,378,112,1120,2025-07-27
FC_GA04,SKU001056,831,241,590,140,1400,2025-07-22
FC_GA04,SKU001817,541,142,399,84,840,2025-07-22
FC_GA04,SKU001622,593,162,431,112,1120,2025-07-25
FC_GA04,SKU000963,838,258,580,140,1400,2025-07-23
FC_GA04,SKU000768,800,229,571,140,1400,2025-07-25
FC_GA04,SKU001857,255,70,185,56,560,2025-07-22
FC_GA04,SKU001976,270,71,199,56,560,2025-07-26
FC_GA04,SKU001274,1651,490,1161,210,2100,2025-07-21
FC_GA04,SKU000684,790,255,535,140,1400,2025-07-23
FC_GA04,SKU000141,1587,489,1098,210,2100,2025-07-27
FC_GA04,SKU000907,547,176,371,84,840,2025-07-26
FC_GA04,SKU001993,524,145,379,84,840,2025-07-24
FC_GA04,SKU000643,841,252,589,140,1400,2025-07-26
FC_GA04,SKU001258,631,176,455,112,1120,2025-07-23
FC_GA04,SKU001031,253,81,172,56,560,2025-07-22
FC_GA04,SKU000793,247,72,175,56,560,2025-07-22
FC_GA04,SKU001604,272,84,188,56,560,2025-07-23
FC_GA04,SKU001844,617,180,437,112,1120,2025-07-22
FC_GA04,SKU001987,261,71,190,56,560,2025-07-22
FC_GA04,SKU001582,832,253,579,140,1400,2025-07-24
FC_GA04,SKU001955,256,74,182,56,560,2025-07-22
FC_GA04,SKU001146,265,80,185,56,560,2025-07-26
FC_GA04,SKU000402,1545,451,1094,210,2100,2025-07-23
FC_GA04,SKU001548,844,251,593,140,1400,2025-07-26
FC_GA04,SKU001271,827,253,574,140,1400,2025-07-27
FC_GA04,SKU001321,823,241,582,140,1400,2025-07-23
FC_GA04,SKU000272,828,281,547,140,1400,2025-07-25
FC_GA04,SKU001473,561,170,391,84,840,2025-07-27
FC_GA04,SKU000545,565,185,380,112,1120,2025-07-21
FC_GA04,SKU000653,236,86,150,56,560,2025-07-22
FC_GA04,SKU001828,832,211,621,140,1400,2025-07-25
FC_GA04,SKU000243,613,190,423,112,1120,2025-07-24
FC_GA04,SKU001181,527,156,371,84,840,2025-07-22
FC_GA04,SKU000618,530,153,377,84,840,2025-07-24
FC_GA04,SKU000508,581,164,417,84,840,2025-07-25
FC_GA04,SKU001732,1627,467,1160,210,2100,2025-07-22
FC_GA04,SKU000225,825,258,567,140,1400,2025-07-27
FC_GA04,SKU000346,266,65,201,56,560,2025-07-26
FC_GA04,SKU000354,591,175,416,112,1120,2025-07-27
FC_GA04,SKU001812,832,259,573,140,1400,2025-07-24
FC_GA04,SKU000625,1614,457,1157,210,2100,2025-07-26
FC_GA04,SKU000776,808,246,562,140,1400,2025-07-25
FC_GA04,SKU001790,276,77,199,56,560,2025-07-21
FC_GA04,SKU000292,554,175,379,84,840,2025-07-24
FC_GA04,SKU001500,576,160,416,112,1120,2025-07-24
FC_GA04,SKU001077,268,84,184,56,560,2025-07-26
FC_GA04,SKU001101,554,161,393,84,840,2025-07-24
FC_GA04,SKU001552,555,142,413,84,840,2025-07-22
FC_GA04,SKU000531,650,181,469,112,1120,2025-07-26
FC_GA04,SKU001439,1609,473,1136,210,2100,2025-07-26
FC_GA04,SKU000504,539,170,369,84,840,2025-07-24
FC_GA04,SKU000476,546,167,379,84,840,2025-07-23
FC_GA04,SKU001075,624,190,434,112,1120,2025-07-24
FC_GA04,SKU000426,1597,472,1125,210,2100,2025-07-24
FC_GA04,SKU001901,551,161,390,84,840,2025-07-21
FC_GA04,SKU000541,523,150,373,84,840,2025-07-21
FC_GA04,SKU000131,238,67,171,56,560,2025-07-25
FC_GA04,SKU000605,541,174,367,84,840,2025-07-26
FC_GA04,SKU001299,647,178,469,112,1120,2025-07-24
FC_GA04,SKU000939,641,180,461,112,1120,2025-07-21
FC_GA04,SKU000411,800,218,582,140,1400,2025-07-25
FC_GA04,SKU000333,646,204,442,112,1120,2025-07-24
FC_GA04,SKU001392,632,149,483,112,1120,2025-07-23
FC_GA04,SKU000315,608,171,437,112,1120,2025-07-25
FC_GA04,SKU001192,912,259,653,140,1400,2025-07-23
FC_GA04,SKU001234,619,220,399,112,1120,2025-07-23
FC_GA04,SKU000281,1643,484,1159,210,2100,2025-07-23
FC_GA04,SKU000320,1600,491,1109,210,2100,2025-07-22
FC_GA04,SKU000223,257,79,178,56,560,2025-07-24
FC_GA04,SKU000231,827,261,566,140,1400,2025-07-24
FC_GA04,SKU001406,597,199,398,112,1120,2025-07-24
FC_GA04,SKU001756,262,88,174,56,560,2025-07-27
FC_GA04,SKU000074,1536,471,1065,210,2100,2025-07-23
FC_GA04,SKU001764,1535,419,1116,210,2100,2025-07-24
FC_GA04,SKU001550,288,79,209,56,560,2025-07-25
FC_GA04,SKU001486,278,95,183,56,560,2025-07-22
FC_GA04,SKU000128,641,183,458,112,1120,2025-07-27
FC_GA04,SKU000697,623,197,426,112,1120,2025-07-25
FC_GA04,SKU000770,817,234,583,140,1400,2025-07-24
FC_GA04,SKU000058,602,191,411,112,1120,2025-07-21
FC_GA04,SKU001285,266,85,181,56,560,2025-07-27
FC_GA04,SKU001123,268,83,185,56,560,2025-07-26
FC_GA04,SKU001150,1557,472,1085,210,2100,2025-07-26
FC_GA04,SKU000762,797,240,557,140,1400,2025-07-24
FC_GA04,SKU000736,581,185,396,84,840,2025-07-24
FC_GA04,SKU000747,1624,525,1099,210,2100,2025-07-26
FC_GA04,SKU001939,511,130,381,84,840,2025-07-22
FC_GA04,SKU001678,257,69,188,56,560,2025-07-27
FC_GA04,SKU000997,224,69,155,56,560,2025-07-22
FC_GA04,SKU001430,1596,473,1123,210,2100,2025-07-24
FC_GA04,SKU001567,610,185,425,112,1120,2025-07-26
FC_GA04,SKU001438,856,261,595,140,1400,2025-07-21
FC_GA04,SKU001286,548,153,395,84,840,2025-07-26
FC_GA04,SKU001899,1583,509,1074,210,2100,2025-07-26
FC_GA04,SKU001182,850,313,537,140,1400,2025-07-23
FC_GA04,SKU000570,1646,528,1118,210,2100,2025-07-25
FC_GA04,SKU000973,234,75,159,56,560,2025-07-21
FC_GA04,SKU000602,236,71,165,56,560,2025-07-22
FC_GA04,SKU001643,552,152,400,84,840,2025-07-26
FC_GA04,SKU001584,593,172,421,112,1120,2025-07-23
FC_GA04,SKU001813,807,223,584,140,1400,2025-07-23
FC_GA04,SKU000970,1627,493,1134,210,2100,2025-07-21
FC_GA04,SKU001776,866,253,613,140,1400,2025-07-24
FC_GA04,SKU001989,1534,456,1078,210,2100,2025-07-23
FC_GA04,SKU001661,245,69,176,56,560,2025-07-26
FC_GA04,SKU001254,1553,474,1079,210,2100,2025-07-26
FC_GA04,SKU000788,1518,451,1067,210,2100,2025-07-22
FC_GA04,SKU000033,1518,471,1047,210,2100,2025-07-24
FC_GA04,SKU001923,567,171,396,84,840,2025-07-24
FC_GA04,SKU000826,840,265,575,140,1400,2025-07-27
FC_GA04,SKU000101,632,191,441,112,1120,2025-07-26
FC_GA04,SKU000391,1589,456,1133,210,2100,2025-07-23
FC_GA04,SKU001630,578,163,415,112,1120,2025-07-24
FC_GA04,SKU001476,554,165,389,84,840,2025-07-27
FC_GA04,SKU001232,1520,475,1045,210,2100,2025-07-24
FC_GA04,SKU000172,250,60,190,56,560,2025-07-22
FC_GA04,SKU000201,574,183,391,84,840,2025-07-26
FC_GA04,SKU000827,535,156,379,84,840,2025-07-22
FC_GA04,SKU001615,1558,445,1113,210,2100,2025-07-25
FC_GA04,SKU001449,1581,481,1100,210,2100,2025-07-23
FC_GA04,SKU000956,887,275,612,140,1400,2025-07-27
FC_GA04,SKU000921,559,156,403,84,840,2025-07-23
FC_GA04,SKU001947,534,171,363,84,840,2025-07-21
FC_GA04,SKU000245,867,254,613,140,1400,2025-07-24
FC_GA04,SKU001417,1619,503,1116,210,2100,2025-07-26
FC_GA04,SKU001863,557,170,387,84,840,2025-07-27
FC_GA04,SKU001944,1590,479,1111,210,2100,2025-07-22
FC_GA04,SKU001569,615,196,419,112,1120,2025-07-21
FC_GA04,SKU000926,253,74,179,56,560,2025-07-27
FC_GA04,SKU000107,871,274,597,140,1400,2025-07-21
FC_GA04,SKU000393,247,64,183,56,560,2025-07-27
FC_GA04,SKU001061,540,169,371,84,840,2025-07-23
FC_GA04,SKU001770,1577,475,1102,210,2100,2025-07-21
FC_GA04,SKU001963,549,160,389,84,840,2025-07-26
FC_GA04,SKU001065,1559,469,1090,210,2100,2025-07-27
FC_GA04,SKU001681,833,250,583,140,1400,2025-07-21
FC_GA04,SKU000494,543,163,380,84,840,2025-07-27
FC_GA04,SKU000900,253,82,171,56,560,2025-07-27
FC_GA04,SKU000712,628,201,427,112,1120,2025-07-23
FC_GA04,SKU001846,885,277,608,140,1400,2025-07-23
FC_GA04,SKU000378,844,256,588,140,1400,2025-07-21
FC_GA04,SKU001656,863,256,607,140,1400,2025-07-22
FC_GA04,SKU001373,236,67,169,56,560,2025-07-25
FC_GA04,SKU000751,602,191,411,112,1120,2025-07-23
FC_GA04,SKU000922,246,73,173,56,560,2025-07-22
FC_GA04,SKU001225,606,198,408,112,1120,2025-07-21
FC_GA04,SKU000775,528,155,373,84,840,2025-07-24
FC_GA04,SKU000667,260,65,195,56,560,2025-07-22
FC_GA04,SKU000236,830,257,573,140,1400,2025-07-23
FC_GA04,SKU001798,228,58,170,56,560,2025-07-25
FC_GA04,SKU000416,257,87,170,56,560,2025-07-24
FC_GA04,SKU001755,1536,453,1083,210,2100,2025-07-26
FC_GA04,SKU000045,229,71,158,56,560,2025-07-27
FC_GA04,SKU001850,244,55,189,56,560,2025-07-21
FC_GA04,SKU000507,1542,450,1092,210,2100,2025-07-23
FC_GA04,SKU000995,1551,477,1074,210,2100,2025-07-21
FC_GA04,SKU000247,850,248,602,140,1400,2025-07-22
FC_GA04,SKU001386,522,164,358,84,840,2025-07-26
FC_GA04,SKU000533,250,67,183,56,560,2025-07-22
FC_GA04,SKU001494,601,194,407,112,1120,2025-07-21
FC_GA04,SKU000351,535,154,381,84,840,2025-07-23
FC_GA04,SKU000257,635,217,418,112,1120,2025-07-24
FC_GA04,SKU001781,249,75,174,56,560,2025-07-22
FC_GA04,SKU000050,567,155,412,84,840,2025-07-21
FC_GA04,SKU000790,254,84,170,56,560,2025-07-21
FC_GA04,SKU001220,1636,462,1174,210,2100,2025-07-23
FC_GA04,SKU001305,1605,474,1131,210,2100,2025-07-23
FC_GA04,SKU000497,1587,525,1062,210,2100,2025-07-26
FC_GA04,SKU001297,873,272,601,140,1400,2025-07-27
FC_GA04,SKU001177,602,190,412,84,840,2025-07-22
FC_GA04,SKU001017,870,228,642,140,1400,2025-07-25
FC_GA04,SKU001141,1600,473,1127,210,2100,2025-07-26
FC_GA04,SKU001380,248,74,174,56,560,2025-07-27
FC_GA04,SKU000620,529,142,387,84,840,2025-07-27
FC_GA04,SKU000552,1597,525,1072,210,2100,2025-07-27
FC_GA04,SKU001931,600,187,413,84,840,2025-07-27
FC_GA04,SKU001173,533,152,381,84,840,2025-07-24
FC_GA04,SKU000783,586,174,412,84,840,2025-07-25
FC_GA04,SKU001558,883,278,605,140,1400,2025-07-24
FC_GA04,SKU000910,276,78,198,56,560,2025-07-23
FC_GA04,SKU001928,653,202,451,112,1120,2025-07-23
FC_GA04,SKU000234,493,152,341,84,840,2025-07-26
FC_GA04,SKU000313,1580,436,1144,210,2100,2025-07-21
FC_GA04,SKU001421,632,191,441,112,1120,2025-07-23
FC_GA04,SKU001697,890,258,632,140,1400,2025-07-23
FC_GA04,SKU001633,544,152,392,84,840,2025-07-23
FC_GA04,SKU001559,1622,460,1162,210,2100,2025-07-24
FC_GA04,SKU000008,1574,467,1107,210,2100,2025-07-21
FC_GA04,SKU001230,569,184,385,112,1120,2025-07-27
FC_GA04,SKU001502,544,171,373,84,840,2025-07-21
FC_GA04,SKU000362,605,162,443,112,1120,2025-07-26
FC_GA04,SKU000833,665,192,473,112,1120,2025-07-26
FC_GA04,SKU001108,266,64,202,56,560,2025-07-21
FC_GA04,SKU000982,246,74,172,56,560,2025-07-21
FC_GA04,SKU001045,227,57,170,56,560,2025-07-23
FC_GA04,SKU000114,251,66,185,56,560,2025-07-26
FC_GA04,SKU001816,237,72,165,56,560,2025-07-27
FC_GA04,SKU000330,1578,499,1079,210,2100,2025-07-22
FC_GA04,SKU000609,561,164,397,112,1120,2025-07-26
FC_GA04,SKU001916,590,177,413,112,1120,2025-07-22
FC_GA04,SKU000696,1578,483,1095,210,2100,2025-07-25
FC_GA04,SKU000361,623,166,457,112,1120,2025-07-21
FC_GA04,SKU000260,781,239,542,140,1400,2025-07-25
FC_GA04,SKU001945,1507,477,1030,210,2100,2025-07-27
FC_GA04,SKU001107,592,173,419,112,1120,2025-07-24
FC_GA04,SKU001499,1644,485,1159,210,2100,2025-07-22
FC_GA04,SKU001255,818,265,553,140,1400,2025-07-24
FC_GA04,SKU001456,602,212,390,112,1120,2025-07-25
FC_GA04,SKU001472,859,232,627,140,1400,2025-07-21
FC_GA04,SKU001383,260,74,186,56,560,2025-07-27
FC_GA04,SKU000401,832,223,609,140,1400,2025-07-27
FC_GA04,SKU001853,558,160,398,84,840,2025-07-27
FC_GA04,SKU001238,577,196,381,84,840,2025-07-25
FC_GA04,SKU001125,618,170,448,112,1120,2025-07-27
FC_GA04,SKU000557,547,156,391,84,840,2025-07-22
FC_GA04,SKU000368,646,205,441,112,1120,2025-07-21
FC_GA04,SKU001140,798,227,571,140,1400,2025-07-27
FC_GA04,SKU000993,628,178,450,112,1120,2025-07-24
FC_GA04,SKU000639,516,135,381,84,840,2025-07-22
FC_GA04,SKU001649,556,153,403,112,1120,2025-07-25
FC_GA04,SKU000632,833,243,590,140,1400,2025-07-22
FC_GA04,SKU000452,840,242,598,140,1400,2025-07-23
FC_GA04,SKU001450,518,139,379,84,840,2025-07-22
FC_GA04,SKU001988,850,245,605,140,1400,2025-07-27
FC_GA04,SKU000757,227,64,163,56,560,2025-07-26
FC_GA04,SKU001310,251,72,179,56,560,2025-07-25
FC_GA04,SKU000548,248,58,190,56,560,2025-07-21
FC_GA04,SKU001051,578,171,407,84,840,2025-07-21
FC_GA04,SKU000725,634,208,426,112,1120,2025-07-27
FC_GA04,SKU001188,915,284,631,140,1400,2025-07-26
FC_GA04,SKU001919,828,218,610,140,1400,2025-07-24
FC_GA04,SKU001095,834,238,596,140,1400,2025-07-24
FC_GA04,SKU000259,1601,489,1112,210,2100,2025-07-22
FC_GA04,SKU001309,243,74,169,56,560,2025-07-22
FC_GA04,SKU001631,841,280,561,140,1400,2025-07-26
FC_GA04,SKU001709,266,83,183,56,560,2025-07-22
FC_GA04,SKU000766,249,76,173,56,560,2025-07-25
FC_GA04,SKU000487,237,81,156,56,560,2025-07-21
FC_GA04,SKU000626,628,190,438,112,1120,2025-07-23
FC_GA04,SKU001742,518,148,370,84,840,2025-07-25
FC_GA04,SKU001763,885,289,596,140,1400,2025-07-24
FC_GA04,SKU001407,889,314,575,140,1400,2025-07-27
FC_GA04,SKU001686,597,178,419,112,1120,2025-07-26
FC_GA04,SKU000664,846,226,620,140,1400,2025-07-24
FC_GA04,SKU001261,256,63,193,56,560,2025-07-26
FC_GA04,SKU000953,517,135,382,84,840,2025-07-22
FC_GA04,SKU001013,279,86,193,56,560,2025-07-25
FC_GA04,SKU001724,1549,463,1086,210,2100,2025-07-21
FC_GA04,SKU001598,261,84,177,56,560,2025-07-22
FC_GA04,SKU001712,609,187,422,112,1120,2025-07-22
FC_GA04,SKU001331,1566,435,1131,210,2100,2025-07-24
FC_GA04,SKU000262,258,81,177,56,560,2025-07-27
FC_GA04,SKU000703,514,161,353,84,840,2025-07-26
FC_GA04,SKU000687,509,152,357,84,840,2025-07-27
FC_GA04,SKU000319,220,48,172,56,560,2025-07-24
FC_GA04,SKU000049,879,271,608,140,1400,2025-07-27
FC_GA04,SKU000117,850,274,576,140,1400,2025-07-23
FC_GA04,SKU000190,1543,480,1063,210,2100,2025-07-24
FC_GA04,SKU000981,541,145,396,84,840,2025-07-23
FC_GA04,SKU001691,807,218,589,140,1400,2025-07-22
FC_GA04,SKU001553,631,175,456,84,840,2025-07-27
FC_GA04,SKU001210,832,263,569,140,1400,2025-07-26
FC_GA04,SKU000479,812,249,563,140,1400,2025-07-27
FC_GA04,SKU001881,264,64,200,56,560,2025-07-26
FC_GA04,SKU001111,839,277,562,140,1400,2025-07-26
FC_GA04,SKU000072,608,197,411,112,1120,2025-07-21
FC_GA04,SKU000038,1621,494,1127,210,2100,2025-07-25
FC_GA04,SKU001508,817,254,563,140,1400,2025-07-24
FC_GA04,SKU001162,628,180,448,112,1120,2025-07-23
FC_GA04,SKU001382,258,92,166,56,560,2025-07-27
FC_GA04,SKU001291,1527,460,1067,210,2100,2025-07-25
FC_GA04,SKU000264,867,283,584,140,1400,2025-07-24
FC_GA04,SKU000648,1508,459,1049,210,2100,2025-07-26
FC_GA04,SKU001363,250,57,193,56,560,2025-07-21
FC_GA04,SKU001217,1567,499,1068,210,2100,2025-07-24
FC_GA04,SKU000379,602,183,419,112,1120,2025-07-26
FC_GA04,SKU001428,1577,509,1068,210,2100,2025-07-27
FC_GA04,SKU001918,846,258,588,140,1400,2025-07-21
FC_GA04,SKU001142,1574,473,1101,210,2100,2025-07-21
FC_GA04,SKU000433,251,73,178,56,560,2025-07-26
FC_GA04,SKU001872,245,79,166,56,560,2025-07-22
FC_GA04,SKU001070,899,279,620,140,1400,2025-07-22
FC_GA04,SKU001855,1564,483,1081,210,2100,2025-07-21
FC_GA04,SKU001545,562,178,384,84,840,2025-07-23
FC_GA04,SKU000809,600,173,427,112,1120,2025-07-25
FC_GA04,SKU001517,249,67,182,56,560,2025-07-23
FC_GA04,SKU000332,871,263,608,140,1400,2025-07-23
FC_GA04,SKU000370,875,272,603,140,1400,2025-07-25
FC_GA04,SKU001984,521,136,385,84,840,2025-07-23
FC_GA04,SKU000395,820,266,554,140,1400,2025-07-25
FC_GA04,SKU000237,1525,461,1064,210,2100,2025-07-22
FC_GA04,SKU000871,593,167,426,112,1120,2025-07-22
FC_GA04,SKU000715,502,139,363,84,840,2025-07-26
FC_GA04,SKU001083,1664,542,1122,210,2100,2025-07-23
FC_GA04,SKU000318,530,140,390,84,840,2025-07-23
FC_GA04,SKU001727,833,264,569,140,1400,2025-07-24
FC_GA04,SKU000090,1646,524,1122,210,2100,2025-07-21
FC_GA04,SKU000359,852,270,582,140,1400,2025-07-25
FC_GA04,SKU001034,854,255,599,140,1400,2025-07-22
FC_GA04,SKU000005,825,250,575,140,1400,2025-07-25
FC_GA04,SKU001198,802,246,556,140,1400,2025-07-24
FC_GA04,SKU000446,1581,475,1106,210,2100,2025-07-27
FC_GA04,SKU000258,1546,485,1061,210,2100,2025-07-27
FC_GA04,SKU000718,505,160,345,84,840,2025-07-26
FC_GA04,SKU001429,790,236,554,140,1400,2025-07-26
FC_GA04,SKU001542,827,272,555,140,1400,2025-07-24
FC_GA04,SKU000813,557,172,385,84,840,2025-07-22
FC_GA04,SKU000303,250,70,180,56,560,2025-07-24
FC_GA04,SKU001775,642,175,467,112,1120,2025-07-23
FC_GA04,SKU000394,245,90,155,56,560,2025-07-27
FC_GA04,SKU001044,578,175,403,84,840,2025-07-26
FC_GA04,SKU000410,552,154,398,84,840,2025-07-21
FC_GA04,SKU001214,1698,495,1203,210,2100,2025-07-25
FC_GA04,SKU000450,600,174,426,112,1120,2025-07-22
FC_GA04,SKU000988,511,138,373,84,840,2025-07-21
FC_GA04,SKU000909,531,139,392,84,840,2025-07-25
FC_GA04,SKU001400,640,193,447,112,1120,2025-07-24
FC_GA04,SKU001867,612,177,435,112,1120,2025-07-22
FC_GA04,SKU001398,575,183,392,84,840,2025-07-22
FC_GA04,SKU001806,836,241,595,140,1400,2025-07-22
FC_GA04,SKU000071,1555,460,1095,210,2100,2025-07-27
FC_GA04,SKU001035,839,240,599,140,1400,2025-07-27
FC_GA04,SKU001864,533,163,370,84,840,2025-07-25
FC_GA04,SKU001961,571,181,390,84,840,2025-07-24
FC_GA04,SKU001096,839,244,595,140,1400,2025-07-22
FC_GA04,SKU001823,270,85,185,56,560,2025-07-22
FC_GA04,SKU000428,627,174,453,112,1120,2025-07-25
FC_GA04,SKU000761,592,163,429,112,1120,2025-07-24
FC_GA04,SKU000454,575,187,388,84,840,2025-07-25
FC_GA04,SKU001599,617,167,450,112,1120,2025-07-22
FC_GA04,SKU001078,823,232,591,140,1400,2025-07-26
FC_GA04,SKU001660,548,180,368,84,840,2025-07-23
FC_GA04,SKU001161,650,204,446,112,1120,2025-07-23
FC_GA04,SKU000024,641,192,449,112,1120,2025-07-25
FC_GA04,SKU001132,583,173,410,112,1120,2025-07-25
FC_GA04,SKU000980,260,80,180,56,560,2025-07-26
FC_GA04,SKU001312,779,229,550,140,1400,2025-07-24
FC_GA04,SKU000308,855,254,601,140,1400,2025-07-27
FC_GA04,SKU001302,595,184,411,112,1120,2025-07-22
FC_GA04,SKU000028,1597,463,1134,210,2100,2025-07-24
FC_GA04,SKU001259,841,247,594,140,1400,2025-07-23
FC_GA04,SKU001215,608,185,423,112,1120,2025-07-22
FC_GA04,SKU001959,839,252,587,140,1400,2025-07-23
FC_GA04,SKU001518,801,250,551,140,1400,2025-07-26
FC_GA04,SKU000187,488,132,356,84,840,2025-07-24
FC_GA04,SKU000862,570,164,406,84,840,2025-07-21
FC_GA04,SKU000750,612,168,444,112,1120,2025-07-21
FC_GA04,SKU001796,617,200,417,112,1120,2025-07-22
FC_GA04,SKU000249,599,188,411,112,1120,2025-07-27
FC_GA04,SKU000444,564,184,380,84,840,2025-07-27
FC_GA04,SKU000492,848,256,592,140,1400,2025-07-21
FC_GA04,SKU001143,230,73,157,56,560,2025-07-22
FC_GA04,SKU000721,623,164,459,112,1120,2025-07-22
FC_GA04,SKU001098,1591,482,1109,210,2100,2025-07-21
FC_GA04,SKU001657,1519,421,1098,210,2100,2025-07-25
FC_GA04,SKU000456,262,94,168,56,560,2025-07-24
FC_GA04,SKU001058,248,79,169,56,560,2025-07-27
FC_GA04,SKU001347,1514,446,1068,210,2100,2025-07-22
FC_GA04,SKU000569,552,198,354,84,840,2025-07-23
FC_GA04,SKU000519,272,73,199,56,560,2025-07-24
FC_GA04,SKU000206,840,253,587,140,1400,2025-07-24
FC_GA04,SKU001932,761,222,539,140,1400,2025-07-23
FC_GA04,SKU000595,1631,523,1108,210,2100,2025-07-22
FC_GA04,SKU001926,632,193,439,112,1120,2025-07-25
FC_GA04,SKU000278,831,255,576,140,1400,2025-07-25
FC_GA04,SKU000011,528,152,376,84,840,2025-07-24
FC_GA04,SKU001374,544,165,379,84,840,2025-07-27
FC_GA04,SKU000061,630,170,460,112,1120,2025-07-24
FC_GA04,SKU001722,270,80,190,56,560,2025-07-21
FC_GA04,SKU001139,1535,461,1074,210,2100,2025-07-27
FC_GA04,SKU000565,929,277,652,140,1400,2025-07-27
FC_GA04,SKU001136,546,156,390,84,840,2025-07-22
FC_GA04,SKU000080,897,247,650,140,1400,2025-07-26
FC_GA04,SKU000669,267,80,187,56,560,2025-07-27
FC_GA04,SKU000976,619,180,439,112,1120,2025-07-25
FC_GA04,SKU001063,842,248,594,140,1400,2025-07-24
FC_GA04,SKU001969,632,212,420,112,1120,2025-07-21
FC_GA04,SKU000814,1531,455,1076,210,2100,2025-07-26
FC_GA04,SKU001443,801,234,567,140,1400,2025-07-22
FC_GA04,SKU001481,1581,501,1080,210,2100,2025-07-25
FC_GA04,SKU001176,1624,481,1143,210,2100,2025-07-24
FC_GA04,SKU000385,629,195,434,112,1120,2025-07-23
FC_GA04,SKU001821,250,74,176,56,560,2025-07-25
FC_GA04,SKU000112,1584,500,1084,210,2100,2025-07-27
FC_GA04,SKU001448,236,67,169,56,560,2025-07-21
FC_GA04,SKU001023,871,265,606,140,1400,2025-07-23
FC_GA04,SKU001707,519,156,363,84,840,2025-07-24
FC_GA04,SKU000859,654,206,448,112,1120,2025-07-25
FC_GA04,SKU001057,581,184,397,84,840,2025-07-24
FC_GA04,SKU001982,823,240,583,140,1400,2025-07-27
FC_GA04,SKU000652,832,231,601,140,1400,2025-07-23
FC_GA04,SKU000291,1598,487,1111,210,2100,2025-07-21
FC_GA04,SKU000034,627,209,418,112,1120,2025-07-24
FC_GA04,SKU000066,258,74,184,56,560,2025-07-24
FC_GA04,SKU001750,1584,466,1118,210,2100,2025-07-21
FC_GA04,SKU000345,1593,454,1139,210,2100,2025-07-27
FC_GA04,SKU000113,498,168,330,84,840,2025-07-21
FC_GA04,SKU001883,1620,473,1147,210,2100,2025-07-21
FC_GA04,SKU001938,1606,475,1131,210,2100,2025-07-21
FC_GA04,SKU001100,667,208,459,112,1120,2025-07-21
FC_GA04,SKU000743,1619,427,1192,210,2100,2025-07-26
FC_GA04,SKU001049,594,177,417,84,840,2025-07-24
FC_GA04,SKU000756,535,144,391,84,840,2025-07-25
FC_GA04,SKU000815,898,296,602,140,1400,2025-07-27
FC_GA04,SKU000010,264,79,185,56,560,2025-07-22
FC_GA04,SKU001904,808,251,557,140,1400,2025-07-27
FC_GA04,SKU001990,570,172,398,112,1120,2025-07-23
FC_GA04,SKU000096,1563,408,1155,210,2100,2025-07-23
FC_GA04,SKU000188,571,154,417,84,840,2025-07-23
FC_GA04,SKU000397,1614,490,1124,210,2100,2025-07-22
FC_GA04,SKU000841,233,90,143,56,560,2025-07-25
FC_GA04,SKU001441,548,165,383,84,840,2025-07-26
FC_GA04,SKU001519,503,156,347,84,840,2025-07-23
FC_GA04,SKU001412,549,151,398,84,840,2025-07-25
FC_GA04,SKU001698,882,271,611,140,1400,2025-07-25
FC_GA04,SKU001008,537,149,388,84,840,2025-07-24
FC_GA04,SKU000763,872,268,604,140,1400,2025-07-21
FC_GA04,SKU001427,542,179,363,84,840,2025-07-23
FC_GA04,SKU000427,851,223,628,140,1400,2025-07-21
FC_GA04,SKU001800,784,264,520,140,1400,2025-07-26
FC_GA04,SKU000439,267,74,193,56,560,2025-07-25
FC_GA04,SKU000700,253,79,174,56,560,2025-07-21
FC_GA04,SKU001535,854,263,591,140,1400,2025-07-25
FC_GA04,SKU000118,830,254,576,140,1400,2025-07-27
FC_GA04,SKU001163,621,195,426,112,1120,2025-07-27
FC_GA04,SKU001865,873,277,596,140,1400,2025-07-27
FC_GA04,SKU001805,818,238,580,140,1400,2025-07-21
FC_GA04,SKU001818,1531,422,1109,210,2100,2025-07-26
FC_GA04,SKU001858,1613,490,1123,210,2100,2025-07-24
FC_GA04,SKU000138,610,189,421,112,1120,2025-07-21
FC_GA04,SKU000863,603,184,419,84,840,2025-07-27
FC_GA04,SKU001287,547,161,386,84,840,2025-07-22
FC_GA04,SKU000342,639,195,444,112,1120,2025-07-21
FC_GA04,SKU001785,1621,461,1160,210,2100,2025-07-25
FC_GA04,SKU000403,243,72,171,56,560,2025-07-26
FC_GA04,SKU001589,1584,495,1089,210,2100,2025-07-22
FC_GA04,SKU000806,564,158,406,84,840,2025-07-21
FC_GA04,SKU001859,537,138,399,84,840,2025-07-27
FC_GA04,SKU000316,864,242,622,140,1400,2025-07-22
FC_GA04,SKU000016,637,204,433,112,1120,2025-07-26
FC_GA04,SKU001356,283,82,201,56,560,2025-07-25
FC_GA04,SKU000420,511,162,349,84,840,2025-07-25
FC_GA04,SKU000461,609,180,429,112,1120,2025-07-22
FC_GA04,SKU001627,845,244,601,140,1400,2025-07-21
FC_GA04,SKU001666,1552,453,1099,210,2100,2025-07-24
FC_GA04,SKU001754,545,169,376,84,840,2025-07-22
FC_GA04,SKU001040,576,171,405,84,840,2025-07-21
FC_GA04,SKU001797,1601,484,1117,210,2100,2025-07-27
FC_GA04,SKU001725,527,162,365,84,840,2025-07-25
FC_GA04,SKU001346,805,250,555,140,1400,2025-07-24
FC_GA04,SKU001765,867,251,616,140,1400,2025-07-23
FC_GA04,SKU001690,568,146,422,84,840,2025-07-27
FC_GA04,SKU000337,263,81,182,56,560,2025-07-24
FC_GA04,SKU001645,837,230,607,140,1400,2025-07-24
FC_GA04,SKU001384,1620,489,1131,210,2100,2025-07-25
FC_GA04,SKU000949,853,248,605,140,1400,2025-07-25
FC_GA04,SKU000568,262,73,189,56,560,2025-07-27
FC_GA04,SKU001591,512,144,368,84,840,2025-07-23
FC_GA04,SKU001748,569,169,400,84,840,2025-07-23
FC_GA04,SKU000179,246,91,155,56,560,2025-07-22
FC_GA04,SKU001609,1606,500,1106,210,2100,2025-07-27
FC_GA04,SKU001960,640,221,419,112,1120,2025-07-25
FC_GA04,SKU000205,1612,452,1160,210,2100,2025-07-26
FC_GA04,SKU000073,584,168,416,112,1120,2025-07-25
FC_GA04,SKU000674,262,82,180,56,560,2025-07-25
FC_GA04,SKU000732,829,244,585,140,1400,2025-07-24
FC_GA04,SKU000621,238,75,163,56,560,2025-07-27
FC_GA04,SKU000710,257,78,179,56,560,2025-07-23
FC_GA04,SKU000920,245,79,166,56,560,2025-07-24
FC_GA04,SKU001962,526,170,356,84,840,2025-07-26
FC_GA04,SKU000838,808,236,572,140,1400,2025-07-27
FC_GA04,SKU001695,573,149,424,112,1120,2025-07-22
FC_GA04,SKU000290,533,163,370,84,840,2025-07-22
FC_GA04,SKU001307,867,238,629,140,1400,2025-07-25
FC_GA04,SKU000109,573,185,388,112,1120,2025-07-27
FC_GA04,SKU000879,511,163,348,84,840,2025-07-27
FC_GA04,SKU001612,523,145,378,84,840,2025-07-27
FC_GA04,SKU000478,611,177,434,112,1120,2025-07-22
FC_GA04,SKU001927,541,139,402,84,840,2025-07-21
FC_GA04,SKU001655,632,191,441,112,1120,2025-07-26
FC_GA04,SKU001327,566,145,421,112,1120,2025-07-27
FC_GA04,SKU001281,1569,443,1126,210,2100,2025-07-25
FC_GA04,SKU000951,258,70,188,56,560,2025-07-23
FC_GA04,SKU001320,858,271,587,140,1400,2025-07-23
FC_GA04,SKU001831,847,249,598,140,1400,2025-07-21
FC_GA04,SKU001378,595,172,423,112,1120,2025-07-21
FC_GA04,SKU001826,618,185,433,112,1120,2025-07-26
FC_GA04,SKU001385,619,196,423,112,1120,2025-07-21
FC_GA04,SKU001025,258,76,182,56,560,2025-07-23
FC_GA04,SKU000032,536,154,382,84,840,2025-07-21
FC_GA04,SKU001780,572,179,393,84,840,2025-07-26
FC_GA04,SKU000019,1555,478,1077,210,2100,2025-07-27
FC_GA04,SKU000390,1555,495,1060,210,2100,2025-07-22
FC_GA04,SKU001054,1591,482,1109,210,2100,2025-07-26
FC_GA04,SKU000585,253,73,180,56,560,2025-07-26
FC_GA04,SKU000572,854,256,598,140,1400,2025-07-22
FC_GA04,SKU000078,256,79,177,56,560,2025-07-24
FC_GA04,SKU001751,637,201,436,112,1120,2025-07-23
FC_GA04,SKU000925,264,81,183,56,560,2025-07-24
FC_GA04,SKU001539,643,182,461,112,1120,2025-07-25
FC_GA04,SKU001600,839,238,601,140,1400,2025-07-27
FC_GA04,SKU001894,511,154,357,84,840,2025-07-27
FC_GA04,SKU001541,1511,444,1067,210,2100,2025-07-22
FC_GA04,SKU001134,1560,426,1134,210,2100,2025-07-22
FC_GA04,SKU000658,1520,443,1077,210,2100,2025-07-22
FC_GA04,SKU001684,1546,427,1119,210,2100,2025-07-23
FC_GA04,SKU001834,260,71,189,56,560,2025-07-26
FC_GA04,SKU000250,610,183,427,112,1120,2025-07-26
FC_GA04,SKU001888,872,271,601,140,1400,2025-07-26
FC_GA04,SKU001328,607,173,434,112,1120,2025-07-22
FC_GA04,SKU000035,877,280,597,140,1400,2025-07-25
FC_GA04,SKU000051,646,213,433,112,1120,2025-07-22
FC_GA04,SKU000248,1635,505,1130,210,2100,2025-07-27
FC_GA04,SKU000947,663,201,462,112,1120,2025-07-21
FC_GA04,SKU001069,825,260,565,140,1400,2025-07-26
FC_GA04,SKU001372,507,147,360,84,840,2025-07-27
FC_GA04,SKU001706,221,48,173,56,560,2025-07-24
FC_GA04,SKU001339,846,267,579,140,1400,2025-07-24
FC_GA04,SKU000241,1536,461,1075,210,2100,2025-07-22
FC_GA04,SKU000740,546,170,376,84,840,2025-07-24
FC_GA04,SKU000046,813,236,577,140,1400,2025-07-25
FC_GA04,SKU001794,631,190,441,112,1120,2025-07-26
FC_GA04,SKU001906,566,161,405,84,840,2025-07-26
FC_GA04,SKU001935,509,169,340,84,840,2025-07-21
FC_GA04,SKU000211,875,251,624,140,1400,2025-07-21
FC_GA04,SKU001761,621,200,421,112,1120,2025-07-24
FC_GA04,SKU001654,246,67,179,56,560,2025-07-22
FC_GA04,SKU000355,827,230,597,140,1400,2025-07-25
FC_GA04,SKU001596,615,176,439,112,1120,2025-07-26
FC_GA04,SKU000550,839,294,545,140,1400,2025-07-25
FC_GA04,SKU000242,238,81,157,56,560,2025-07-24
FC_GA04,SKU001174,568,159,409,84,840,2025-07-27
FC_GA04,SKU001511,243,68,175,56,560,2025-07-22
FC_GA04,SKU001652,252,66,186,56,560,2025-07-23
FC_GA04,SKU000284,856,256,600,140,1400,2025-07-25
FC_GA04,SKU000023,616,189,427,112,1120,2025-07-24
FC_GA04,SKU001549,637,204,433,112,1120,2025-07-24
FC_GA04,SKU000238,1560,489,1071,210,2100,2025-07-25
FC_GA04,SKU000915,256,74,182,56,560,2025-07-27
FC_GA04,SKU000324,1608,495,1113,210,2100,2025-07-24
FC_GA04,SKU001316,1525,451,1074,210,2100,2025-07-26
FC_GA04,SKU001469,1637,517,1120,210,2100,2025-07-27
FC_GA04,SKU000804,240,71,169,56,560,2025-07-25
FC_GA04,SKU000559,546,160,386,84,840,2025-07-22
FC_GA04,SKU001554,841,233,608,140,1400,2025-07-25
FC_GA04,SKU001908,1557,473,1084,210,2100,2025-07-21
FC_GA04,SKU000966,626,198,428,112,1120,2025-07-24
FC_GA04,SKU000623,810,247,563,140,1400,2025-07-27
FC_GA04,SKU000896,844,256,588,140,1400,2025-07-21
FC_GA04,SKU001050,580,166,414,112,1120,2025-07-21
FC_GA04,SKU000341,624,162,462,112,1120,2025-07-24
FC_GA04,SKU000801,256,74,182,56,560,2025-07-21
FC_GA04,SKU001648,232,77,155,56,560,2025-07-21
FC_GA04,SKU000158,524,166,358,84,840,2025-07-25
FC_GA04,SKU000003,609,197,412,112,1120,2025-07-24
FC_GA04,SKU000344,818,270,548,140,1400,2025-07-24
FC_GA04,SKU001318,515,167,348,84,840,2025-07-24
FC_GA04,SKU000588,864,238,626,140,1400,2025-07-27
FC_GA04,SKU000941,249,76,173,56,560,2025-07-26
FC_GA04,SKU001801,774,238,536,140,1400,2025-07-23
FC_GA04,SKU000645,592,172,420,112,1120,2025-07-25
FC_GA04,SKU001808,622,182,440,112,1120,2025-07-22
FC_GA04,SKU001431,540,162,378,84,840,2025-07-22
FC_GA04,SKU000737,1616,488,1128,210,2100,2025-07-26
FC_GA04,SKU001610,235,54,181,56,560,2025-07-25
FC_GA04,SKU001874,1543,459,1084,210,2100,2025-07-23
FC_GA04,SKU000695,633,172,461,112,1120,2025-07-27
FC_GA04,SKU000622,1520,458,1062,210,2100,2025-07-26
FC_GA04,SKU000978,543,163,380,84,840,2025-07-23
FC_GA04,SKU001323,799,263,536,140,1400,2025-07-21
FC_GA04,SKU000376,1625,508,1117,210,2100,2025-07-26
FC_GA04,SKU001694,250,77,173,56,560,2025-07-25
FC_GA04,SKU001453,536,155,381,84,840,2025-07-25
FC_GA04,SKU001103,612,193,419,112,1120,2025-07-25
FC_GA04,SKU000523,622,174,448,112,1120,2025-07-26
FC_GA04,SKU001004,582,170,412,84,840,2025-07-25
FC_GA04,SKU000317,622,191,431,112,1120,2025-07-22
FC_GA04,SKU000944,266,100,166,56,560,2025-07-24
FC_GA04,SKU000903,1611,464,1147,210,2100,2025-07-24
FC_GA04,SKU001265,866,253,613,140,1400,2025-07-23
FC_GA04,SKU001089,511,163,348,84,840,2025-07-21
FC_GA04,SKU000097,255,79,176,56,560,2025-07-23
FC_GA04,SKU000610,248,89,159,56,560,2025-07-22
FC_GA04,SKU000901,621,188,433,112,1120,2025-07-24
FC_GA04,SKU001733,576,166,410,112,1120,2025-07-26
FC_GA04,SKU001278,539,163,376,84,840,2025-07-26
FC_GA04,SKU000009,527,165,362,84,840,2025-07-21
FC_GA04,SKU001226,273,83,190,56,560,2025-07-25
FC_GA04,SKU000874,549,157,392,84,840,2025-07-25
FC_GA04,SKU000935,1572,502,1070,210,2100,2025-07-27
FC_GA04,SKU000767,821,254,567,140,1400,2025-07-21
FC_GA04,SKU001047,865,262,603,140,1400,2025-07-22
FC_GA04,SKU001326,248,73,175,56,560,2025-07-22
FC_GA04,SKU000556,650,190,460,112,1120,2025-07-24
FC_GA04,SKU000170,843,224,619,140,1400,2025-07-25
FC_GA04,SKU001717,252,74,178,56,560,2025-07-21
FC_GA04,SKU000738,248,68,180,56,560,2025-07-26
FC_GA04,SKU000214,561,170,391,112,1120,2025-07-26
FC_GA04,SKU000353,1609,474,1135,210,2100,2025-07-27
FC_GA04,SKU000070,1520,424,1096,210,2100,2025-07-23
FC_GA04,SKU000246,808,226,582,140,1400,2025-07-26
FC_GA04,SKU000181,855,256,599,140,1400,2025-07-23
FC_GA04,SKU001868,567,183,384,84,840,2025-07-24
FC_GA04,SKU001999,258,79,179,56,560,2025-07-21
FC_GA04,SKU001701,835,251,584,140,1400,2025-07-26
FC_GA04,SKU001625,863,253,610,140,1400,2025-07-27
FC_GA04,SKU000302,247,77,170,56,560,2025-07-21
FC_GA04,SKU000429,1617,480,1137,210,2100,2025-07-22
FC_GA04,SKU001470,849,254,595,140,1400,2025-07-27
FC_GA04,SKU001172,912,286,626,140,1400,2025-07-22
FC_GA04,SKU001052,804,265,539,140,1400,2025-07-22
FC_GA04,SKU001376,591,169,422,112,1120,2025-07-26
FC_GA04,SKU001626,1573,487,1086,210,2100,2025-07-22
FC_GA04,SKU001757,1577,466,1111,210,2100,2025-07-26
FC_GA04,SKU001998,805,230,575,140,1400,2025-07-26
FC_GA04,SKU001165,503,170,333,84,840,2025-07-23
FC_GA04,SKU001437,559,166,393,84,840,2025-07-23
FC_GA04,SKU001571,1541,438,1103,210,2100,2025-07-23
FC_GA04,SKU000014,838,254,584,140,1400,2025-07-25
FC_GA04,SKU001734,648,197,451,112,1120,2025-07-23
FC_GA04,SKU001752,253,77,176,56,560,2025-07-26
FC_GA04,SKU001991,573,166,407,112,1120,2025-07-21
FC_GA04,SKU000087,590,156,434,112,1120,2025-07-22
FC_GA04,SKU001390,591,181,410,84,840,2025-07-26
FC_GA04,SKU000466,840,253,587,140,1400,2025-07-26
FC_GA04,SKU001171,1587,493,1094,210,2100,2025-07-23
FC_GA04,SKU000235,797,256,541,140,1400,2025-07-26
FC_GA04,SKU001202,536,139,397,84,840,2025-07-25
FC_GA04,SKU000938,256,79,177,56,560,2025-07-25
FC_GA04,SKU000044,257,74,183,56,560,2025-07-27
FC_GA04,SKU001579,235,65,170,56,560,2025-07-21
FC_GA04,SKU000876,827,244,583,140,1400,2025-07-23
FC_GA04,SKU001183,550,158,392,84,840,2025-07-22
FC_GA04,SKU001084,586,175,411,84,840,2025-07-26
FC_GA04,SKU000615,590,172,418,112,1120,2025-07-22
FC_GA04,SKU001357,636,218,418,112,1120,2025-07-23
FC_GA04,SKU001388,568,174,394,84,840,2025-07-25
FC_GA04,SKU000407,661,204,457,112,1120,2025-07-24
FC_GA04,SKU001914,888,287,601,140,1400,2025-07-22
FC_GA04,SKU000979,843,261,582,140,1400,2025-07-26
FC_GA04,SKU000161,552,142,410,84,840,2025-07-21
FC_GA04,SKU000578,865,259,606,140,1400,2025-07-21
FC_GA04,SKU001912,833,265,568,140,1400,2025-07-27
FC_GA04,SKU001485,620,198,422,112,1120,2025-07-22
FC_GA04,SKU001870,267,80,187,56,560,2025-07-23
FC_GA04,SKU001829,1569,505,1064,210,2100,2025-07-23
FC_GA04,SKU000022,869,265,604,140,1400,2025-07-22
FC_GA04,SKU000440,867,264,603,140,1400,2025-07-21
FC_GA04,SKU000121,522,157,365,84,840,2025-07-21
FC_GA04,SKU001884,560,158,402,84,840,2025-07-23
FC_GA04,SKU001377,1527,463,1064,210,2100,2025-07-24
FC_GA04,SKU001954,1618,481,1137,210,2100,2025-07-23
FC_GA04,SKU001425,638,191,447,112,1120,2025-07-21
FC_GA04,SKU000509,1584,475,1109,210,2100,2025-07-24
FC_GA04,SKU001968,543,173,370,84,840,2025-07-25
FC_GA04,SKU000561,268,96,172,56,560,2025-07-26
FC_GA04,SKU001509,647,203,444,112,1120,2025-07-24
FC_GA04,SKU000860,849,267,582,140,1400,2025-07-21
FC_GA04,SKU000269,262,75,187,56,560,2025-07-26
FC_GA04,SKU000017,531,163,368,84,840,2025-07-22
FC_GA04,SKU000899,545,154,391,84,840,2025-07-27
FC_GA04,SKU000872,835,239,596,140,1400,2025-07-25
FC_GA04,SKU000490,620,192,428,112,1120,2025-07-23
FC_GA04,SKU001218,821,234,587,140,1400,2025-07-23
FC_GA04,SKU001121,229,66,163,56,560,2025-07-22
FC_GA04,SKU001445,594,193,401,112,1120,2025-07-21
FC_GA04,SKU000693,233,70,163,56,560,2025-07-25
FC_GA04,SKU001268,258,84,174,56,560,2025-07-25
FC_GA04,SKU000240,265,76,189,56,560,2025-07-24
FC_GA04,SKU000707,256,84,172,56,560,2025-07-27
FC_GA04,SKU000382,623,173,450,112,1120,2025-07-23
FC_GA04,SKU000289,547,154,393,84,840,2025-07-24
FC_GA04,SKU000219,257,68,189,56,560,2025-07-26
FC_GA04,SKU001086,653,196,457,112,1120,2025-07-23
FC_GA04,SKU001009,1630,515,1115,210,2100,2025-07-27
FC_GA04,SKU000464,270,86,184,56,560,2025-07-26
FC_GA04,SKU001835,525,151,374,84,840,2025-07-25
FC_GA04,SKU001744,602,188,414,112,1120,2025-07-23
FC_GA04,SKU001414,1621,489,1132,210,2100,2025-07-22
FC_GA04,SKU000663,260,90,170,56,560,2025-07-27
FC_GA04,SKU001869,519,175,344,84,840,2025-07-24
FC_GA04,SKU001147,612,189,423,112,1120,2025-07-27
FC_GA04,SKU000389,603,164,439,112,1120,2025-07-23
FC_GA04,SKU000417,249,71,178,56,560,2025-07-23
FC_GA04,SKU001444,247,79,168,56,560,2025-07-25
FC_GA04,SKU001688,612,165,447,112,1120,2025-07-24
FC_GA04,SKU000564,638,181,457,112,1120,2025-07-27
FC_GA04,SKU001520,559,173,386,84,840,2025-07-22
FC_GA04,SKU001530,491,149,342,84,840,2025-07-22
FC_GA04,SKU000335,606,187,419,112,1120,2025-07-25
FC_GA04,SKU001760,1551,456,1095,210,2100,2025-07-22
FC_GA04,SKU000495,243,68,175,56,560,2025-07-26
FC_GA04,SKU001811,264,62,202,56,560,2025-07-24
FC_GA04,SKU001298,248,74,174,56,560,2025-07-25
FC_GA04,SKU000812,879,236,643,140,1400,2025-07-27
FC_GA04,SKU000748,643,168,475,112,1120,2025-07-26
FC_GA04,SKU000163,1513,480,1033,210,2100,2025-07-21
FC_GA04,SKU000012,818,251,567,140,1400,2025-07-25
FC_GA04,SKU001129,826,249,577,140,1400,2025-07-25
FC_GA04,SKU001849,239,62,177,56,560,2025-07-23
FC_GA04,SKU000110,877,260,617,140,1400,2025-07-23
FC_GA04,SKU000917,558,171,387,84,840,2025-07-21
FC_GA04,SKU000771,1563,479,1084,210,2100,2025-07-23
FC_GA04,SKU000821,534,164,370,84,840,2025-07-22
FC_GA04,SKU001447,833,229,604,140,1400,2025-07-22
FC_GA04,SKU001189,595,194,401,112,1120,2025-07-22
FC_GA04,SKU000314,1554,441,1113,210,2100,2025-07-26
FC_GA04,SKU000116,1534,443,1091,210,2100,2025-07-27
FC_GA04,SKU000392,607,195,412,112,1120,2025-07-27
FC_GA04,SKU001152,545,177,368,84,840,2025-07-21
FC_GA04,SKU000321,1559,482,1077,210,2100,2025-07-26
FC_GA04,SKU001371,547,167,380,84,840,2025-07-21
FC_GA04,SKU000824,1616,455,1161,210,2100,2025-07-22
FC_GA04,SKU001102,255,79,176,56,560,2025-07-27
FC_GA04,SKU001370,856,244,612,140,1400,2025-07-22
FC_GA04,SKU001716,821,256,565,140,1400,2025-07-22
FC_GA04,SKU000516,611,179,432,112,1120,2025-07-25
FC_GA04,SKU001977,614,164,450,112,1120,2025-07-25
FC_GA04,SKU001972,283,100,183,56,560,2025-07-26
FC_GA04,SKU000212,861,273,588,140,1400,2025-07-24
FC_GA04,SKU001783,879,260,619,140,1400,2025-07-22
FC_GA04,SKU001279,277,90,187,56,560,2025-07-22
FC_GA04,SKU001900,582,171,411,84,840,2025-07-25
FC_GA04,SKU000596,553,146,407,84,840,2025-07-22
FC_GA04,SKU001898,541,169,372,84,840,2025-07-23
FC_GA04,SKU001676,1576,463,1113,210,2100,2025-07-22
FC_GA04,SKU000537,630,182,448,112,1120,2025-07-27
FC_GA04,SKU001288,560,185,375,84,840,2025-07-27
FC_GA04,SKU001886,545,177,368,84,840,2025-07-23
FC_GA04,SKU000782,827,258,569,140,1400,2025-07-23
FC_GA04,SKU000779,1597,469,1128,210,2100,2025-07-24
FC_GA04,SKU001623,627,172,455,112,1120,2025-07-21
FC_GA04,SKU000054,1567,429,1138,210,2100,2025-07-21
FC_GA04,SKU000465,846,246,600,140,1400,2025-07-26
FC_GA04,SKU001354,506,154,352,84,840,2025-07-27
FC_GA04,SKU000252,629,187,442,112,1120,2025-07-21
FC_GA04,SKU000701,1603,498,1105,210,2100,2025-07-24
FC_GA04,SKU000115,1602,487,1115,210,2100,2025-07-24
FC_GA04,SKU001015,280,82,198,56,560,2025-07-25
FC_GA04,SKU000151,231,61,170,56,560,2025-07-25
FC_GA04,SKU001116,539,184,355,84,840,2025-07-26
FC_GA04,SKU001822,1643,528,1115,210,2100,2025-07-26
FC_GA04,SKU001046,617,198,419,112,1120,2025-07-25
FC_GA04,SKU000430,811,229,582,140,1400,2025-07-25
FC_GA04,SKU001860,237,92,145,56,560,2025-07-22
FC_GA04,SKU001875,631,194,437,112,1120,2025-07-25
FC_GA04,SKU000191,1623,493,1130,210,2100,2025-07-23
FC_GA04,SKU000279,1578,483,1095,210,2100,2025-07-25
FC_GA04,SKU000193,643,182,461,112,1120,2025-07-26
FC_GA04,SKU001033,807,236,571,140,1400,2025-07-22
FC_GA04,SKU001897,232,59,173,56,560,2025-07-22
FC_GA04,SKU001420,536,155,381,84,840,2025-07-26
FC_GA04,SKU000699,247,63,184,56,560,2025-07-22
FC_GA04,SKU001680,553,145,408,84,840,2025-07-22
FC_GA04,SKU001830,250,68,182,56,560,2025-07-21
FC_GA04,SKU001825,560,174,386,84,840,2025-07-23
FC_GA04,SKU001018,557,177,380,84,840,2025-07-24
FC_GA04,SKU000484,872,261,611,140,1400,2025-07-25
FC_GA04,SKU000140,233,71,162,56,560,2025-07-26
FC_GA04,SKU001768,242,65,177,56,560,2025-07-24
FC_GA04,SKU000027,629,181,448,112,1120,2025-07-22
FC_GA04,SKU000062,247,81,166,56,560,2025-07-26
FC_GA04,SKU001169,620,190,430,112,1120,2025-07-25
FC_GA04,SKU001930,510,146,364,84,840,2025-07-25
FC_GA04,SKU000111,240,61,179,56,560,2025-07-25
FC_GA04,SKU001020,272,85,187,56,560,2025-07-23
FC_GA04,SKU001128,1672,470,1202,210,2100,2025-07-23
FC_GA04,SKU000457,860,255,605,140,1400,2025-07-21
FC_GA04,SKU001227,1612,492,1120,210,2100,2025-07-21
FC_GA04,SKU001362,571,178,393,84,840,2025-07-22
FC_GA04,SKU001958,636,187,449,112,1120,2025-07-23
FC_GA04,SKU001498,639,170,469,112,1120,2025-07-24
FC_GA04,SKU000175,622,172,450,112,1120,2025-07-23
FC_GA04,SKU000649,540,175,365,84,840,2025-07-22
FC_GA04,SKU000878,580,189,391,112,1120,2025-07-23
FC_GA04,SKU000293,599,196,403,112,1120,2025-07-26
FC_GA04,SKU000675,1575,463,1112,210,2100,2025-07-22
FC_GA04,SKU000418,525,142,383,84,840,2025-07-25
FC_GA04,SKU001484,531,157,374,84,840,2025-07-25
FC_GA04,SKU001970,826,255,571,140,1400,2025-07-24
FC_GA04,SKU000965,1618,478,1140,210,2100,2025-07-23
FC_GA04,SKU001252,638,155,483,112,1120,2025-07-23
FC_GA04,SKU001528,546,157,389,84,840,2025-07-23
FC_GA04,SKU001878,248,65,183,56,560,2025-07-25
FC_GA04,SKU000855,595,179,416,112,1120,2025-07-22
FC_GA04,SKU000126,1585,475,1110,210,2100,2025-07-26
FC_GA04,SKU001005,834,254,580,140,1400,2025-07-22
FC_GA04,SKU000950,589,192,397,84,840,2025-07-21
FC_GA04,SKU001240,1666,525,1141,210,2100,2025-07-21
FC_GA04,SKU001971,480,141,339,84,840,2025-07-21
FC_GA04,SKU001296,621,185,436,112,1120,2025-07-24
FC_GA04,SKU000442,262,79,183,56,560,2025-07-22
FC_GA04,SKU000459,813,277,536,140,1400,2025-07-22
FC_GA04,SKU001097,249,60,189,56,560,2025-07-26
FC_GA04,SKU001741,824,256,568,140,1400,2025-07-21
FC_GA04,SKU001726,1602,451,1151,210,2100,2025-07-23
FC_GA04,SKU000754,279,77,202,56,560,2025-07-21
FC_GA04,SKU000937,238,70,168,56,560,2025-07-26
FC_GA04,SKU001986,1592,471,1121,210,2100,2025-07-26
FC_GA04,SKU000535,251,83,168,56,560,2025-07-26
FC_GA04,SKU001719,613,179,434,112,1120,2025-07-24
FC_GA04,SKU000286,818,258,560,140,1400,2025-07-22
FC_GA04,SKU001344,1535,470,1065,210,2100,2025-07-21
FC_GA04,SKU001843,613,208,405,112,1120,2025-07-22
FC_GA04,SKU001570,633,163,470,112,1120,2025-07-22
FC_GA04,SKU001665,478,143,335,84,840,2025-07-27
FC_GA04,SKU001995,534,146,388,84,840,2025-07-23
FC_GA04,SKU000807,265,81,184,56,560,2025-07-21
FC_GA04,SKU001735,1516,411,1105,210,2100,2025-07-21
FC_GA04,SKU000529,513,139,374,84,840,2025-07-21
FC_GA04,SKU001574,290,88,202,56,560,2025-07-21
FC_GA04,SKU001340,872,282,590,140,1400,2025-07-22
FC_GA04,SKU001789,274,72,202,56,560,2025-07-21
FC_GA04,SKU000918,589,179,410,112,1120,2025-07-24
FC_GA04,SKU001641,523,156,367,84,840,2025-07-25
FC_GA04,SKU000275,627,195,432,112,1120,2025-07-21
FC_GA04,SKU000758,527,146,381,84,840,2025-07-21
FC_GA04,SKU001011,818,250,568,140,1400,2025-07-25
FC_GA04,SKU001001,1560,442,1118,210,2100,2025-07-23
FC_GA04,SKU000277,872,260,612,140,1400,2025-07-21
FC_GA04,SKU001616,246,73,173,56,560,2025-07-24
FC_GA04,SKU001587,243,80,163,56,560,2025-07-25
FC_GA04,SKU001538,860,310,550,140,1400,2025-07-25
FC_GA04,SKU000971,1583,462,1121,210,2100,2025-07-26
FC_GA04,SKU001920,901,277,624,140,1400,2025-07-27
FC_GA04,SKU001673,531,164,367,84,840,2025-07-25
FC_GA04,SKU001885,604,185,419,112,1120,2025-07-25
FC_GA04,SKU001483,1718,476,1242,210,2100,2025-07-22
FC_GA04,SKU000449,241,69,172,56,560,2025-07-21
FC_GA04,SKU001943,1642,493,1149,210,2100,2025-07-23
FC_GA04,SKU000659,270,73,197,56,560,2025-07-27
FC_GA04,SKU000488,558,160,398,84,840,2025-07-25
FC_GA04,SKU000514,258,100,158,56,560,2025-07-23
FC_GA04,SKU000563,834,249,585,140,1400,2025-07-26
FC_GA04,SKU001256,273,76,197,56,560,2025-07-23
FC_GA04,SKU001322,1638,527,1111,210,2100,2025-07-22
FC_GA04,SKU000380,610,200,410,112,1120,2025-07-26
FC_GA04,SKU000367,596,162,434,112,1120,2025-07-27
FC_GA04,SKU000886,236,64,172,56,560,2025-07-23
FC_GA04,SKU000026,603,158,445,112,1120,2025-07-27
FC_GA04,SKU001003,1602,467,1135,210,2100,2025-07-23
FC_GA04,SKU000958,575,194,381,112,1120,2025-07-21
FC_GA04,SKU000522,510,156,354,84,840,2025-07-23
FC_GA04,SKU000856,843,270,573,140,1400,2025-07-25
FC_GA04,SKU001409,554,163,391,84,840,2025-07-23
FC_GA04,SKU001229,290,95,195,56,560,2025-07-23
FC_GA04,SKU001832,643,200,443,112,1120,2025-07-24
FC_GA04,SKU001079,238,69,169,56,560,2025-07-24
FC_GA04,SKU001746,861,244,617,140,1400,2025-07-27
FC_GA04,SKU000443,1569,469,1100,210,2100,2025-07-27
FC_GA04,SKU000196,520,165,355,84,840,2025-07-27
FC_GA04,SKU000312,827,253,574,140,1400,2025-07-21
FC_GA04,SKU000168,791,243,548,140,1400,2025-07-26
FC_GA04,SKU001597,823,256,567,140,1400,2025-07-25
FC_GA04,SKU001110,251,104,147,56,560,2025-07-26
FC_GA04,SKU000897,272,93,179,56,560,2025-07-25
FC_GA04,SKU000942,608,192,416,112,1120,2025-07-26
FC_GA04,SKU000197,1582,463,1119,210,2100,2025-07-26
FC_GA04,SKU001933,1594,456,1138,210,2100,2025-07-25
FC_GA04,SKU001896,582,164,418,84,840,2025-07-24
FC_GA04,SKU000473,843,245,598,140,1400,2025-07-24
FC_GA04,SKU000673,612,187,425,112,1120,2025-07-23
FC_GA04,SKU001160,601,188,413,84,840,2025-07-27
FC_GA04,SKU000730,539,166,373,84,840,2025-07-25
FC_GA04,SKU001389,555,178,377,84,840,2025-07-22
FC_GA04,SKU000936,1635,422,1213,210,2100,2025-07-27
FC_GA04,SKU001459,606,188,418,112,1120,2025-07-27
FC_GA04,SKU000388,614,197,417,112,1120,2025-07-22
FC_GA04,SKU001196,843,268,575,140,1400,2025-07-24
FC_GA04,SKU001862,230,81,149,56,560,2025-07-26
FC_GA04,SKU000819,835,230,605,140,1400,2025-07-23
FC_GA04,SKU001682,808,238,570,140,1400,2025-07-21
FC_GA04,SKU001524,1516,456,1060,210,2100,2025-07-23
FC_GA04,SKU000366,1536,484,1052,210,2100,2025-07-24
FC_GA04,SKU001577,1572,467,1105,210,2100,2025-07-25
FC_GA04,SKU001350,564,174,390,84,840,2025-07-23
FC_GA04,SKU001565,577,158,419,84,840,2025-07-24
FC_GA04,SKU001951,1498,417,1081,210,2100,2025-07-26
FC_GA04,SKU001341,819,258,561,140,1400,2025-07-24
FC_GA04,SKU001352,825,219,606,140,1400,2025-07-21
FC_GA04,SKU000914,246,64,182,56,560,2025-07-21
FC_GA04,SKU000808,1623,510,1113,210,2100,2025-07-25
FC_GA04,SKU001468,661,197,464,112,1120,2025-07-21
FC_GA04,SKU000726,248,76,172,56,560,2025-07-27
FC_GA04,SKU001711,555,181,374,84,840,2025-07-24
FC_GA04,SKU001795,863,258,605,140,1400,2025-07-26
FC_GA04,SKU000339,819,250,569,140,1400,2025-07-27
FC_GA04,SKU001809,590,187,403,84,840,2025-07-22
FC_GA04,SKU001466,527,146,381,84,840,2025-07-27
FC_GA04,SKU001042,617,160,457,112,1120,2025-07-22
FC_GA04,SKU000948,1638,501,1137,210,2100,2025-07-22
FC_GA04,SKU001507,1719,516,1203,210,2100,2025-07-22
FC_GA04,SKU000891,540,171,369,84,840,2025-07-23
FC_GA04,SKU000739,844,231,613,140,1400,2025-07-24
FC_GA04,SKU000796,256,80,176,56,560,2025-07-24
FC_GA04,SKU001465,869,250,619,140,1400,2025-07-27
FC_GA04,SKU000787,234,85,149,56,560,2025-07-24
FC_GA04,SKU001772,564,148,416,84,840,2025-07-24
FC_GA04,SKU001168,1596,508,1088,210,2100,2025-07-26
FC_GA04,SKU000854,1554,484,1070,210,2100,2025-07-24
FC_GA04,SKU001905,1589,471,1118,210,2100,2025-07-27
FC_GA04,SKU001854,271,75,196,56,560,2025-07-24
FC_GA04,SKU001410,279,75,204,56,560,2025-07-27
FC_GA04,SKU000216,1531,453,1078,210,2100,2025-07-25
FC_GA04,SKU000288,574,172,402,84,840,2025-07-25
FC_GA04,SKU000583,605,171,434,112,1120,2025-07-24
FC_GA04,SKU001802,529,170,359,84,840,2025-07-24
FC_GA04,SKU000924,1585,478,1107,210,2100,2025-07-24
FC_GA04,SKU001270,1572,464,1108,210,2100,2025-07-21
FC_GA04,SKU000195,830,247,583,140,1400,2025-07-24
FC_GA04,SKU000075,1611,426,1185,210,2100,2025-07-23
FC_GA04,SKU001526,835,259,576,140,1400,2025-07-22
FC_GA04,SKU000057,567,165,402,84,840,2025-07-25
FC_GA04,SKU001583,527,172,355,84,840,2025-07-26
FC_GA04,SKU001546,261,87,174,56,560,2025-07-22
FC_GA04,SKU000849,1576,457,1119,210,2100,2025-07-22
FC_GA04,SKU001580,552,167,385,84,840,2025-07-24
FC_GA04,SKU000789,607,175,432,112,1120,2025-07-22
FC_GA04,SKU000301,596,196,400,112,1120,2025-07-25
FC_GA04,SKU000546,235,73,162,56,560,2025-07-21
FC_GA04,SKU001611,826,224,602,140,1400,2025-07-26
FC_GA04,SKU000990,263,91,172,56,560,2025-07-21
FC_GA04,SKU000823,869,258,611,140,1400,2025-07-23
FC_GA04,SKU000734,575,184,391,84,840,2025-07-23
FC_GA04,SKU000207,1563,474,1089,210,2100,2025-07-22
FC_GA04,SKU001151,601,161,440,112,1120,2025-07-24
FC_GA04,SKU000311,212,68,144,56,560,2025-07-23
FC_GA04,SKU000650,880,247,633,140,1400,2025-07-27
FC_GA04,SKU001368,623,187,436,112,1120,2025-07-22
FC_GA04,SKU000106,259,67,192,56,560,2025-07-26
FC_GA04,SKU000467,253,67,186,56,560,2025-07-25
FC_GA04,SKU001740,569,177,392,84,840,2025-07-24
FC_GA04,SKU001555,863,242,621,140,1400,2025-07-25
FC_GA04,SKU001197,253,65,188,56,560,2025-07-22
FC_GA04,SKU001629,268,71,197,56,560,2025-07-22
FC_GA04,SKU001788,229,76,153,56,560,2025-07-23
FC_GA04,SKU001036,1532,470,1062,210,2100,2025-07-25
FC_GA04,SKU000930,1534,466,1068,210,2100,2025-07-24
FC_GA04,SKU001022,1520,460,1060,210,2100,2025-07-24
FC_GA04,SKU001087,278,82,196,56,560,2025-07-25
FC_GA04,SKU001081,1532,490,1042,210,2100,2025-07-22
FC_GA04,SKU001839,823,261,562,140,1400,2025-07-25
FC_GA04,SKU000913,1624,492,1132,210,2100,2025-07-27
FC_GA04,SKU000679,543,149,394,84,840,2025-07-22
FC_GA04,SKU001148,1594,458,1136,210,2100,2025-07-23
FC_GA04,SKU000470,561,178,383,84,840,2025-07-26
FC_GA04,SKU001703,611,198,413,112,1120,2025-07-23
FC_GA04,SKU001253,260,84,176,56,560,2025-07-21
FC_GA04,SKU000769,622,173,449,112,1120,2025-07-26
FC_GA04,SKU000148,1583,485,1098,210,2100,2025-07-26
FC_GA04,SKU001965,1584,488,1096,210,2100,2025-07-26
FC_GA04,SKU000384,239,64,175,56,560,2025-07-23
FC_GA04,SKU000159,873,261,612,140,1400,2025-07-21
FC_GA04,SKU001593,878,251,627,140,1400,2025-07-26
FC_GA04,SKU000089,255,78,177,56,560,2025-07-27
FC_GA04,SKU000322,834,233,601,140,1400,2025-07-21
FC_GA04,SKU001779,1571,466,1105,210,2100,2025-07-23
FC_GA04,SKU000462,1581,483,1098,210,2100,2025-07-23
FC_GA04,SKU000708,834,248,586,140,1400,2025-07-24
FC_GA04,SKU001276,622,191,431,112,1120,2025-07-25
FC_GA04,SKU000799,631,171,460,112,1120,2025-07-27
FC_GA04,SKU000177,600,147,453,112,1120,2025-07-25
FC_GA04,SKU001027,1579,474,1105,210,2100,2025-07-22
FC_GA04,SKU000139,1508,468,1040,210,2100,2025-07-21
FC_GA04,SKU001301,643,207,436,112,1120,2025-07-26
FC_GA04,SKU000844,879,256,623,140,1400,2025-07-25
FC_GA04,SKU001137,601,165,436,112,1120,2025-07-23
FC_GA04,SKU000657,609,186,423,112,1120,2025-07-27
FC_GA04,SKU000455,525,181,344,84,840,2025-07-22
FC_GA04,SKU000816,619,179,440,112,1120,2025-07-22
FC_GA04,SKU001423,831,235,596,140,1400,2025-07-23
FC_GA04,SKU001705,265,73,192,56,560,2025-07-27
FC_GA04,SKU001424,1553,500,1053,210,2100,2025-07-22
FC_GA04,SKU001637,602,209,393,112,1120,2025-07-27
FC_GA04,SKU001099,1620,493,1127,210,2100,2025-07-27
FC_GA04,SKU000373,254,81,173,56,560,2025-07-22
FC_GA04,SKU000765,566,152,414,112,1120,2025-07-27
FC_GA04,SKU001658,576,170,406,112,1120,2025-07-23
FC_GA04,SKU000136,255,78,177,56,560,2025-07-24
FC_GA04,SKU001455,628,187,441,112,1120,2025-07-21
FC_GA04,SKU000437,1485,456,1029,210,2100,2025-07-26
FC_GA04,SKU001774,1529,459,1070,210,2100,2025-07-23
FC_GA04,SKU000448,579,154,425,112,1120,2025-07-27
FC_GA04,SKU000686,1675,512,1163,210,2100,2025-07-24
FC_GA04,SKU001306,613,162,451,112,1120,2025-07-27
FC_GA04,SKU001837,633,202,431,112,1120,2025-07-24
FC_GA04,SKU000056,522,145,377,84,840,2025-07-25
FC_GA04,SKU001540,851,265,586,140,1400,2025-07-21
FC_GA04,SKU000549,517,169,348,84,840,2025-07-25
FC_GA04,SKU001621,252,75,177,56,560,2025-07-21
FC_GA04,SKU001026,1567,495,1072,210,2100,2025-07-25
FC_GA04,SKU000690,591,151,440,112,1120,2025-07-27
FC_GA04,SKU001335,837,249,588,140,1400,2025-07-22
FC_GA04,SKU000421,276,84,192,56,560,2025-07-25
FC_GA04,SKU000468,851,241,610,140,1400,2025-07-22
FC_GA04,SKU001030,617,175,442,112,1120,2025-07-22
FC_GA04,SKU000836,849,256,593,140,1400,2025-07-24
FC_GA04,SKU001159,542,168,374,84,840,2025-07-26
FC_GA04,SKU001332,210,68,142,56,560,2025-07-22
FC_GA04,SKU001586,1601,471,1130,210,2100,2025-07-26
FC_GA04,SKU001118,548,186,362,84,840,2025-07-27
FC_GA04,SKU001064,1571,462,1109,210,2100,2025-07-25
FC_GA04,SKU000189,236,75,161,56,560,2025-07-25
FC_GA04,SKU001514,234,73,161,56,560,2025-07-25
FC_GA04,SKU000041,618,182,436,112,1120,2025-07-22
FC_GA04,SKU000785,581,169,412,84,840,2025-07-21
FC_GA04,SKU000584,656,185,471,112,1120,2025-07-26
FC_GA04,SKU001334,251,85,166,56,560,2025-07-25
FC_GA04,SKU000662,260,64,196,56,560,2025-07-22
FC_GA04,SKU001921,288,79,209,56,560,2025-07-26
FC_GA04,SKU000198,1643,506,1137,210,2100,2025-07-23
FC_GA04,SKU001019,1520,474,1046,210,2100,2025-07-24
FC_GA04,SKU000873,625,200,425,112,1120,2025-07-23
FC_GA04,SKU001178,1538,461,1077,210,2100,2025-07-27
FC_GA04,SKU001566,1625,441,1184,210,2100,2025-07-22
FC_GA04,SKU000678,1548,472,1076,210,2100,2025-07-24
FC_GA04,SKU001280,1607,464,1143,210,2100,2025-07-24
FC_GA04,SKU001646,516,159,357,84,840,2025-07-25
FC_GA04,SKU000704,510,164,346,84,840,2025-07-25
FC_GA04,SKU001861,1553,543,1010,210,2100,2025-07-25
FC_GA04,SKU001715,831,248,583,140,1400,2025-07-22
FC_GA04,SKU001292,596,182,414,112,1120,2025-07-24
FC_GA04,SKU001452,206,59,147,56,560,2025-07-26
FC_GA04,SKU000989,609,175,434,112,1120,2025-07-25
FC_GA04,SKU000218,1579,510,1069,210,2100,2025-07-23
FC_GA04,SKU000668,803,256,547,140,1400,2025-07-21
FC_GA04,SKU000015,1598,463,1135,210,2100,2025-07-21
FC_GA04,SKU001632,527,174,353,84,840,2025-07-24
FC_GA04,SKU000202,585,169,416,112,1120,2025-07-24
FC_GA04,SKU000540,779,243,536,140,1400,2025-07-25
FC_GA04,SKU001957,1619,478,1141,210,2100,2025-07-23
FC_GA04,SKU000858,528,167,361,84,840,2025-07-23
FC_GA04,SKU000349,634,184,450,112,1120,2025-07-27
FC_GA04,SKU000728,800,266,534,140,1400,2025-07-24
FC_GA04,SKU000582,825,240,585,140,1400,2025-07-24
FC_GA04,SKU001572,796,236,560,140,1400,2025-07-24
FC_GA04,SKU001635,561,136,425,84,840,2025-07-24
FC_GA04,SKU000883,789,220,569,140,1400,2025-07-25
FC_GA04,SKU000404,608,178,430,112,1120,2025-07-21
FC_GA04,SKU000025,536,150,386,84,840,2025-07-22
FC_GA04,SKU000493,238,60,178,56,560,2025-07-22
FC_GA04,SKU001913,548,161,387,84,840,2025-07-22
FC_GA04,SKU000637,524,159,365,84,840,2025-07-22
FC_GA04,SKU001244,1618,452,1166,210,2100,2025-07-21
FC_GA04,SKU000199,567,178,389,112,1120,2025-07-27
FC_GA04,SKU001807,559,164,395,84,840,2025-07-27
FC_GA04,SKU001739,646,176,470,112,1120,2025-07-24
FC_GA04,SKU000498,245,70,175,56,560,2025-07-27
FC_GA04,SKU000759,552,144,408,84,840,2025-07-22
FC_GA04,SKU000713,851,273,578,140,1400,2025-07-23
FC_GA04,SKU000538,905,274,631,140,1400,2025-07-21
FC_GA04,SKU001851,576,177,399,84,840,2025-07-22
FC_GA04,SKU001728,592,210,382,84,840,2025-07-21
FC_GA04,SKU001940,1513,444,1069,210,2100,2025-07-25
FC_NJ05,SKU001178,1557,490,1067,210,2100,2025-07-23
FC_NJ05,SKU000593,873,258,615,140,1400,2025-07-21
FC_NJ05,SKU001396,616,174,442,112,1120,2025-07-27
FC_NJ05,SKU001751,630,180,450,112,1120,2025-07-27
FC_NJ05,SKU001768,244,74,170,56,560,2025-07-27
FC_NJ05,SKU001799,1519,474,1045,210,2100,2025-07-23
FC_NJ05,SKU000332,868,263,605,140,1400,2025-07-21
FC_NJ05,SKU001983,1550,478,1072,210,2100,2025-07-27
FC_NJ05,SKU001235,1569,461,1108,210,2100,2025-07-22
FC_NJ05,SKU001052,835,244,591,140,1400,2025-07-23
FC_NJ05,SKU001878,249,67,182,56,560,2025-07-22
FC_NJ05,SKU001753,244,81,163,56,560,2025-07-21
FC_NJ05,SKU001305,1566,506,1060,210,2100,2025-07-23
FC_NJ05,SKU000842,618,192,426,112,1120,2025-07-24
FC_NJ05,SKU000896,835,253,582,140,1400,2025-07-21
FC_NJ05,SKU000041,607,175,432,112,1120,2025-07-27
FC_NJ05,SKU001609,1578,491,1087,210,2100,2025-07-26
FC_NJ05,SKU000123,828,258,570,140,1400,2025-07-25
FC_NJ05,SKU000274,510,158,352,84,840,2025-07-26
FC_NJ05,SKU001858,1629,498,1131,210,2100,2025-07-21
FC_NJ05,SKU000942,606,155,451,112,1120,2025-07-25
FC_NJ05,SKU001651,510,149,361,84,840,2025-07-27
FC_NJ05,SKU000036,882,287,595,140,1400,2025-07-23
FC_NJ05,SKU001654,245,68,177,56,560,2025-07-27
FC_NJ05,SKU001765,864,253,611,140,1400,2025-07-22
FC_NJ05,SKU001101,525,149,376,84,840,2025-07-27
FC_NJ05,SKU000987,1563,488,1075,210,2100,2025-07-22
FC_NJ05,SKU001980,837,233,604,140,1400,2025-07-25
FC_NJ05,SKU001098,1559,491,1068,210,2100,2025-07-25
FC_NJ05,SKU000649,561,155,406,84,840,2025-07-26
FC_NJ05,SKU000209,528,145,383,84,840,2025-07-24
FC_NJ05,SKU001802,531,150,381,84,840,2025-07-21
FC_NJ05,SKU001470,857,242,615,140,1400,2025-07-21
FC_NJ05,SKU001588,524,166,358,84,840,2025-07-21
FC_NJ05,SKU000522,544,151,393,84,840,2025-07-26
FC_NJ05,SKU000687,556,165,391,84,840,2025-07-26
FC_NJ05,SKU000799,600,178,422,112,1120,2025-07-23
FC_NJ05,SKU000754,260,76,184,56,560,2025-07-24
FC_NJ05,SKU001886,537,160,377,84,840,2025-07-24
FC_NJ05,SKU000895,571,176,395,84,840,2025-07-25
FC_NJ05,SKU000200,1534,434,1100,210,2100,2025-07-23
FC_NJ05,SKU001772,507,136,371,84,840,2025-07-25
FC_NJ05,SKU000653,250,76,174,56,560,2025-07-25
FC_NJ05,SKU000348,631,204,427,112,1120,2025-07-21
FC_NJ05,SKU000832,546,136,410,84,840,2025-07-22
FC_NJ05,SKU001450,503,130,373,84,840,2025-07-22
FC_NJ05,SKU001856,222,60,162,56,560,2025-07-22
FC_NJ05,SKU000564,662,195,467,112,1120,2025-07-23
FC_NJ05,SKU001527,245,72,173,56,560,2025-07-25
FC_NJ05,SKU000434,262,86,176,56,560,2025-07-25
FC_NJ05,SKU000632,832,278,554,140,1400,2025-07-23
FC_NJ05,SKU001456,601,169,432,112,1120,2025-07-21
FC_NJ05,SKU001762,257,91,166,56,560,2025-07-22
FC_NJ05,SKU000286,861,275,586,140,1400,2025-07-22
FC_NJ05,SKU000010,260,85,175,56,560,2025-07-25
FC_NJ05,SKU001249,607,156,451,112,1120,2025-07-23
FC_NJ05,SKU001492,249,53,196,56,560,2025-07-24
FC_NJ05,SKU001036,1579,472,1107,210,2100,2025-07-23
FC_NJ05,SKU001986,1565,440,1125,210,2100,2025-07-26
FC_NJ05,SKU001809,512,173,339,84,840,2025-07-24
FC_NJ05,SKU000358,243,66,177,56,560,2025-07-25
FC_NJ05,SKU001756,257,96,161,56,560,2025-07-26
FC_NJ05,SKU000887,256,97,159,56,560,2025-07-23
FC_NJ05,SKU000472,243,62,181,56,560,2025-07-26
FC_NJ05,SKU001078,764,234,530,140,1400,2025-07-21
FC_NJ05,SKU001091,1609,472,1137,210,2100,2025-07-26
FC_NJ05,SKU000833,633,161,472,112,1120,2025-07-26
FC_NJ05,SKU000619,1638,492,1146,210,2100,2025-07-24
FC_NJ05,SKU000992,242,62,180,56,560,2025-07-26
FC_NJ05,SKU000113,547,175,372,84,840,2025-07-24
FC_NJ05,SKU001138,1605,514,1091,210,2100,2025-07-24
FC_NJ05,SKU000695,675,200,475,112,1120,2025-07-21
FC_NJ05,SKU001348,859,235,624,140,1400,2025-07-23
FC_NJ05,SKU000590,661,198,463,112,1120,2025-07-22
FC_NJ05,SKU000697,607,160,447,112,1120,2025-07-24
FC_NJ05,SKU000633,248,87,161,56,560,2025-07-27
FC_NJ05,SKU001443,869,276,593,140,1400,2025-07-23
FC_NJ05,SKU001710,631,184,447,112,1120,2025-07-23
FC_NJ05,SKU001691,849,265,584,140,1400,2025-07-22
FC_NJ05,SKU001528,593,163,430,84,840,2025-07-21
FC_NJ05,SKU000974,1564,443,1121,210,2100,2025-07-24
FC_NJ05,SKU001374,527,155,372,84,840,2025-07-25
FC_NJ05,SKU001307,838,251,587,140,1400,2025-07-26
FC_NJ05,SKU000227,259,74,185,56,560,2025-07-23
FC_NJ05,SKU000784,549,166,383,84,840,2025-07-21
FC_NJ05,SKU001485,606,191,415,112,1120,2025-07-25
FC_NJ05,SKU000568,256,81,175,56,560,2025-07-25
FC_NJ05,SKU001595,1623,502,1121,210,2100,2025-07-24
FC_NJ05,SKU000892,847,248,599,140,1400,2025-07-23
FC_NJ05,SKU001262,231,62,169,56,560,2025-07-22
FC_NJ05,SKU001563,623,181,442,112,1120,2025-07-22
FC_NJ05,SKU001216,621,167,454,112,1120,2025-07-25
FC_NJ05,SKU001757,1549,514,1035,210,2100,2025-07-27
FC_NJ05,SKU000406,574,173,401,84,840,2025-07-24
FC_NJ05,SKU001005,817,274,543,140,1400,2025-07-25
FC_NJ05,SKU000109,591,190,401,112,1120,2025-07-24
FC_NJ05,SKU000485,548,157,391,84,840,2025-07-21
FC_NJ05,SKU000707,254,72,182,56,560,2025-07-22
FC_NJ05,SKU001183,564,175,389,84,840,2025-07-25
FC_NJ05,SKU000418,552,194,358,84,840,2025-07-24
FC_NJ05,SKU000482,1561,450,1111,210,2100,2025-07-25
FC_NJ05,SKU000615,622,183,439,112,1120,2025-07-21
FC_NJ05,SKU000882,543,169,374,84,840,2025-07-25
FC_NJ05,SKU001072,1513,453,1060,210,2100,2025-07-27
FC_NJ05,SKU001758,544,161,383,84,840,2025-07-23
FC_NJ05,SKU001071,254,72,182,56,560,2025-07-25
FC_NJ05,SKU001820,588,179,409,112,1120,2025-07-21
FC_NJ05,SKU000819,812,246,566,140,1400,2025-07-26
FC_NJ05,SKU001343,563,152,411,84,840,2025-07-22
FC_NJ05,SKU000080,810,235,575,140,1400,2025-07-22
FC_NJ05,SKU000757,248,70,178,56,560,2025-07-27
FC_NJ05,SKU000302,254,77,177,56,560,2025-07-27
FC_NJ05,SKU000682,540,163,377,84,840,2025-07-24
FC_NJ05,SKU000237,1558,465,1093,210,2100,2025-07-27
FC_NJ05,SKU000321,1550,484,1066,210,2100,2025-07-23
FC_NJ05,SKU001577,1554,462,1092,210,2100,2025-07-22
FC_NJ05,SKU000816,624,180,444,112,1120,2025-07-27
FC_NJ05,SKU000323,538,171,367,84,840,2025-07-27
FC_NJ05,SKU000037,636,189,447,112,1120,2025-07-25
FC_NJ05,SKU001942,262,59,203,56,560,2025-07-25
FC_NJ05,SKU000357,1548,482,1066,210,2100,2025-07-27
FC_NJ05,SKU001252,632,192,440,112,1120,2025-07-27
FC_NJ05,SKU000170,834,239,595,140,1400,2025-07-21
FC_NJ05,SKU000362,584,177,407,112,1120,2025-07-22
FC_NJ05,SKU000732,849,261,588,140,1400,2025-07-21
FC_NJ05,SKU001839,809,269,540,140,1400,2025-07-25
FC_NJ05,SKU000859,634,194,440,112,1120,2025-07-25
FC_NJ05,SKU001551,886,270,616,140,1400,2025-07-23
FC_NJ05,SKU000206,836,243,593,140,1400,2025-07-27
FC_NJ05,SKU000578,785,244,541,140,1400,2025-07-25
FC_NJ05,SKU001706,248,78,170,56,560,2025-07-24
FC_NJ05,SKU000650,854,249,605,140,1400,2025-07-24
FC_NJ05,SKU000596,528,138,390,84,840,2025-07-23
FC_NJ05,SKU001039,616,179,437,112,1120,2025-07-21
FC_NJ05,SKU000852,247,65,182,56,560,2025-07-24
FC_NJ05,SKU001863,553,177,376,84,840,2025-07-23
FC_NJ05,SKU000163,1568,477,1091,210,2100,2025-07-23
FC_NJ05,SKU000850,1568,483,1085,210,2100,2025-07-26
FC_NJ05,SKU000012,826,284,542,140,1400,2025-07-22
FC_NJ05,SKU000415,249,64,185,56,560,2025-07-24
FC_NJ05,SKU000870,1587,457,1130,210,2100,2025-07-22
FC_NJ05,SKU000958,628,213,415,112,1120,2025-07-26
FC_NJ05,SKU000492,820,248,572,140,1400,2025-07-23
FC_NJ05,SKU000741,262,77,185,56,560,2025-07-26
FC_NJ05,SKU000686,1643,502,1141,210,2100,2025-07-21
FC_NJ05,SKU001957,1643,504,1139,210,2100,2025-07-26
FC_NJ05,SKU000621,226,73,153,56,560,2025-07-22
FC_NJ05,SKU001054,1575,471,1104,210,2100,2025-07-27
FC_NJ05,SKU001926,625,169,456,112,1120,2025-07-24
FC_NJ05,SKU000665,547,164,383,84,840,2025-07-22
FC_NJ05,SKU001429,872,251,621,140,1400,2025-07-21
FC_NJ05,SKU001089,544,164,380,84,840,2025-07-21
FC_NJ05,SKU000354,627,197,430,112,1120,2025-07-25
FC_NJ05,SKU001741,794,217,577,140,1400,2025-07-21
FC_NJ05,SKU001675,806,228,578,140,1400,2025-07-23
FC_NJ05,SKU000471,240,53,187,56,560,2025-07-24
FC_NJ05,SKU000696,1606,489,1117,210,2100,2025-07-21
FC_NJ05,SKU001048,246,76,170,56,560,2025-07-26
FC_NJ05,SKU000879,517,165,352,84,840,2025-07-27
FC_NJ05,SKU001137,599,180,419,112,1120,2025-07-23
FC_NJ05,SKU000640,273,75,198,56,560,2025-07-26
FC_NJ05,SKU000542,583,158,425,112,1120,2025-07-26
FC_NJ05,SKU001458,251,82,169,56,560,2025-07-27
FC_NJ05,SKU000180,838,236,602,140,1400,2025-07-27
FC_NJ05,SKU000651,876,265,611,140,1400,2025-07-22
FC_NJ05,SKU000645,632,189,443,112,1120,2025-07-21
FC_NJ05,SKU001304,258,82,176,56,560,2025-07-24
FC_NJ05,SKU000316,838,260,578,140,1400,2025-07-27
FC_NJ05,SKU000035,874,256,618,140,1400,2025-07-25
FC_NJ05,SKU001376,567,165,402,112,1120,2025-07-22
FC_NJ05,SKU000916,264,89,175,56,560,2025-07-25
FC_NJ05,SKU001045,263,77,186,56,560,2025-07-21
FC_NJ05,SKU000319,251,69,182,56,560,2025-07-25
FC_NJ05,SKU000135,514,160,354,84,840,2025-07-24
FC_NJ05,SKU000715,539,180,359,84,840,2025-07-23
FC_NJ05,SKU000084,609,182,427,112,1120,2025-07-24
FC_NJ05,SKU000766,257,87,170,56,560,2025-07-27
FC_NJ05,SKU000951,223,66,157,56,560,2025-07-26
FC_NJ05,SKU001889,1578,472,1106,210,2100,2025-07-27
FC_NJ05,SKU000098,1540,436,1104,210,2100,2025-07-24
FC_NJ05,SKU001410,253,72,181,56,560,2025-07-21
FC_NJ05,SKU001142,1569,471,1098,210,2100,2025-07-24
FC_NJ05,SKU000767,846,265,581,140,1400,2025-07-22
FC_NJ05,SKU001011,806,245,561,140,1400,2025-07-24
FC_NJ05,SKU000231,779,223,556,140,1400,2025-07-27
FC_NJ05,SKU000178,580,181,399,84,840,2025-07-22
FC_NJ05,SKU000260,846,233,613,140,1400,2025-07-24
FC_NJ05,SKU000116,1541,500,1041,210,2100,2025-07-21
FC_NJ05,SKU001024,531,153,378,84,840,2025-07-27
FC_NJ05,SKU000378,828,268,560,140,1400,2025-07-27
FC_NJ05,SKU001564,609,204,405,112,1120,2025-07-26
FC_NJ05,SKU001181,551,165,386,84,840,2025-07-26
FC_NJ05,SKU001127,628,198,430,112,1120,2025-07-27
FC_NJ05,SKU001522,592,170,422,112,1120,2025-07-25
FC_NJ05,SKU000458,257,59,198,56,560,2025-07-21
FC_NJ05,SKU001387,834,239,595,140,1400,2025-07-24
FC_NJ05,SKU001619,829,227,602,140,1400,2025-07-25
FC_NJ05,SKU001836,1653,528,1125,210,2100,2025-07-22
FC_NJ05,SKU001669,579,181,398,84,840,2025-07-22
FC_NJ05,SKU000734,539,174,365,84,840,2025-07-22
FC_NJ05,SKU000644,1542,457,1085,210,2100,2025-07-23
FC_NJ05,SKU001790,227,74,153,56,560,2025-07-26
FC_NJ05,SKU001672,573,171,402,84,840,2025-07-21
FC_NJ05,SKU000940,578,186,392,112,1120,2025-07-21
FC_NJ05,SKU000079,560,162,398,112,1120,2025-07-25
FC_NJ05,SKU000422,276,76,200,56,560,2025-07-27
FC_NJ05,SKU001186,522,129,393,84,840,2025-07-27
FC_NJ05,SKU001955,253,63,190,56,560,2025-07-24
FC_NJ05,SKU001834,234,87,147,56,560,2025-07-21
FC_NJ05,SKU001047,845,249,596,140,1400,2025-07-24
FC_NJ05,SKU000728,839,275,564,140,1400,2025-07-26
FC_NJ05,SKU000284,846,221,625,140,1400,2025-07-25
FC_NJ05,SKU000555,243,70,173,56,560,2025-07-23
FC_NJ05,SKU000558,567,168,399,84,840,2025-07-23
FC_NJ05,SKU000473,833,254,579,140,1400,2025-07-21
FC_NJ05,SKU000939,621,215,406,112,1120,2025-07-24
FC_NJ05,SKU000563,849,237,612,140,1400,2025-07-26
FC_NJ05,SKU000301,634,178,456,112,1120,2025-07-22
FC_NJ05,SKU001088,542,152,390,84,840,2025-07-24
FC_NJ05,SKU001550,262,65,197,56,560,2025-07-22
FC_NJ05,SKU001215,630,167,463,112,1120,2025-07-24
FC_NJ05,SKU001589,1594,440,1154,210,2100,2025-07-27
FC_NJ05,SKU000143,647,205,442,112,1120,2025-07-23
FC_NJ05,SKU001601,587,178,409,84,840,2025-07-27
FC_NJ05,SKU001915,1563,485,1078,210,2100,2025-07-24
FC_NJ05,SKU001945,1508,445,1063,210,2100,2025-07-22
FC_NJ05,SKU001584,625,197,428,112,1120,2025-07-26
FC_NJ05,SKU000508,544,161,383,84,840,2025-07-25
FC_NJ05,SKU000544,598,185,413,112,1120,2025-07-26
FC_NJ05,SKU001793,557,160,397,84,840,2025-07-26
FC_NJ05,SKU000996,804,271,533,140,1400,2025-07-24
FC_NJ05,SKU001905,1590,484,1106,210,2100,2025-07-22
FC_NJ05,SKU001832,641,182,459,112,1120,2025-07-26
FC_NJ05,SKU001439,1616,498,1118,210,2100,2025-07-25
FC_NJ05,SKU001542,845,219,626,140,1400,2025-07-23
FC_NJ05,SKU001302,637,181,456,112,1120,2025-07-26
FC_NJ05,SKU000245,875,249,626,140,1400,2025-07-24
FC_NJ05,SKU000683,523,146,377,84,840,2025-07-25
FC_NJ05,SKU001334,255,71,184,56,560,2025-07-25
FC_NJ05,SKU000242,259,91,168,56,560,2025-07-26
FC_NJ05,SKU000681,1477,482,995,210,2100,2025-07-27
FC_NJ05,SKU001313,1576,509,1067,210,2100,2025-07-25
FC_NJ05,SKU001225,617,193,424,112,1120,2025-07-26
FC_NJ05,SKU000857,1554,481,1073,210,2100,2025-07-23
FC_NJ05,SKU001266,605,174,431,112,1120,2025-07-26
FC_NJ05,SKU001568,857,249,608,140,1400,2025-07-22
FC_NJ05,SKU000126,1593,484,1109,210,2100,2025-07-25
FC_NJ05,SKU000536,1624,545,1079,210,2100,2025-07-24
FC_NJ05,SKU001960,656,187,469,112,1120,2025-07-23
FC_NJ05,SKU000075,1617,485,1132,210,2100,2025-07-25
FC_NJ05,SKU001779,1639,508,1131,210,2100,2025-07-21
FC_NJ05,SKU000417,228,58,170,56,560,2025-07-22
FC_NJ05,SKU000442,230,72,158,56,560,2025-07-22
FC_NJ05,SKU001375,1529,445,1084,210,2100,2025-07-25
FC_NJ05,SKU000602,242,75,167,56,560,2025-07-27
FC_NJ05,SKU000981,575,160,415,84,840,2025-07-25
FC_NJ05,SKU000361,577,196,381,112,1120,2025-07-25
FC_NJ05,SKU000661,255,71,184,56,560,2025-07-22
FC_NJ05,SKU001201,582,187,395,112,1120,2025-07-24
FC_NJ05,SKU000020,548,186,362,84,840,2025-07-21
FC_NJ05,SKU001603,226,66,160,56,560,2025-07-26
FC_NJ05,SKU000817,1582,474,1108,210,2100,2025-07-22
FC_NJ05,SKU000229,258,79,179,56,560,2025-07-26
FC_NJ05,SKU001940,1602,503,1099,210,2100,2025-07-27
FC_NJ05,SKU001330,841,253,588,140,1400,2025-07-26
FC_NJ05,SKU000589,578,179,399,112,1120,2025-07-24
FC_NJ05,SKU000622,1611,496,1115,210,2100,2025-07-26
FC_NJ05,SKU000279,1510,430,1080,210,2100,2025-07-27
FC_NJ05,SKU001649,675,211,464,112,1120,2025-07-22
FC_NJ05,SKU000699,246,77,169,56,560,2025-07-24
FC_NJ05,SKU000639,556,150,406,84,840,2025-07-25
FC_NJ05,SKU000147,260,55,205,56,560,2025-07-24
FC_NJ05,SKU001006,623,190,433,112,1120,2025-07-24
FC_NJ05,SKU001062,259,83,176,56,560,2025-07-23
FC_NJ05,SKU001316,1623,514,1109,210,2100,2025-07-23
FC_NJ05,SKU000218,1528,436,1092,210,2100,2025-07-24
FC_NJ05,SKU000549,557,185,372,84,840,2025-07-22
FC_NJ05,SKU001143,218,72,146,56,560,2025-07-21
FC_NJ05,SKU000641,629,175,454,112,1120,2025-07-22
FC_NJ05,SKU001161,647,211,436,112,1120,2025-07-21
FC_NJ05,SKU000527,267,78,189,56,560,2025-07-21
FC_NJ05,SKU001221,581,188,393,112,1120,2025-07-23
FC_NJ05,SKU001984,544,173,371,84,840,2025-07-27
FC_NJ05,SKU001920,852,269,583,140,1400,2025-07-27
FC_NJ05,SKU000770,843,255,588,140,1400,2025-07-23
FC_NJ05,SKU001666,1623,489,1134,210,2100,2025-07-22
FC_NJ05,SKU000803,620,186,434,112,1120,2025-07-24
FC_NJ05,SKU000866,592,172,420,112,1120,2025-07-27
FC_NJ05,SKU001726,1542,455,1087,210,2100,2025-07-21
FC_NJ05,SKU001328,634,204,430,112,1120,2025-07-24
FC_NJ05,SKU001914,807,231,576,140,1400,2025-07-21
FC_NJ05,SKU000013,655,179,476,112,1120,2025-07-21
FC_NJ05,SKU001656,869,273,596,140,1400,2025-07-22
FC_NJ05,SKU001395,591,189,402,112,1120,2025-07-22
FC_NJ05,SKU001042,598,171,427,112,1120,2025-07-22
FC_NJ05,SKU000110,923,268,655,140,1400,2025-07-21
FC_NJ05,SKU000165,236,62,174,56,560,2025-07-21
FC_NJ05,SKU000533,259,87,172,56,560,2025-07-26
FC_NJ05,SKU001340,806,247,559,140,1400,2025-07-24
FC_NJ05,SKU000814,1622,433,1189,210,2100,2025-07-26
FC_NJ05,SKU001870,260,88,172,56,560,2025-07-24
FC_NJ05,SKU001469,1625,486,1139,210,2100,2025-07-27
FC_NJ05,SKU000922,263,63,200,56,560,2025-07-22
FC_NJ05,SKU000970,1533,522,1011,210,2100,2025-07-24
FC_NJ05,SKU001018,506,141,365,84,840,2025-07-26
FC_NJ05,SKU001987,260,95,165,56,560,2025-07-27
FC_NJ05,SKU000805,856,267,589,140,1400,2025-07-26
FC_NJ05,SKU000625,1568,479,1089,210,2100,2025-07-22
FC_NJ05,SKU000329,565,169,396,84,840,2025-07-24
FC_NJ05,SKU001642,850,247,603,140,1400,2025-07-22
FC_NJ05,SKU000360,241,69,172,56,560,2025-07-23
FC_NJ05,SKU001273,548,168,380,84,840,2025-07-27
FC_NJ05,SKU001613,650,186,464,112,1120,2025-07-21
FC_NJ05,SKU001489,275,102,173,56,560,2025-07-23
FC_NJ05,SKU000025,524,142,382,84,840,2025-07-21
FC_NJ05,SKU001275,252,84,168,56,560,2025-07-23
FC_NJ05,SKU000078,260,78,182,56,560,2025-07-24
FC_NJ05,SKU000630,1613,496,1117,210,2100,2025-07-24
FC_NJ05,SKU000713,815,228,587,140,1400,2025-07-27
FC_NJ05,SKU000638,846,266,580,140,1400,2025-07-22
FC_NJ05,SKU000634,1654,492,1162,210,2100,2025-07-24
FC_NJ05,SKU000122,832,239,593,140,1400,2025-07-26
FC_NJ05,SKU001077,250,69,181,56,560,2025-07-21
FC_NJ05,SKU001876,505,156,349,84,840,2025-07-27
FC_NJ05,SKU000562,851,254,597,140,1400,2025-07-21
FC_NJ05,SKU001257,1603,465,1138,210,2100,2025-07-27
FC_NJ05,SKU001336,606,169,437,112,1120,2025-07-21
FC_NJ05,SKU001133,664,185,479,112,1120,2025-07-23
FC_NJ05,SKU001149,556,153,403,84,840,2025-07-26
FC_NJ05,SKU001240,1555,466,1089,210,2100,2025-07-27
FC_NJ05,SKU001416,1578,490,1088,210,2100,2025-07-25
FC_NJ05,SKU000246,849,283,566,140,1400,2025-07-26
FC_NJ05,SKU000176,576,182,394,112,1120,2025-07-24
FC_NJ05,SKU001571,1593,452,1141,210,2100,2025-07-23
FC_NJ05,SKU001897,256,85,171,56,560,2025-07-25
FC_NJ05,SKU001219,604,182,422,112,1120,2025-07-24
FC_NJ05,SKU000477,519,165,354,84,840,2025-07-22
FC_NJ05,SKU000232,597,190,407,112,1120,2025-07-25
FC_NJ05,SKU001752,253,90,163,56,560,2025-07-24
FC_NJ05,SKU001567,649,197,452,112,1120,2025-07-23
FC_NJ05,SKU000839,245,65,180,56,560,2025-07-24
FC_NJ05,SKU000498,265,76,189,56,560,2025-07-26
FC_NJ05,SKU000033,1594,459,1135,210,2100,2025-07-21
FC_NJ05,SKU001502,562,150,412,84,840,2025-07-23
FC_NJ05,SKU000047,1547,448,1099,210,2100,2025-07-25
FC_NJ05,SKU000273,243,78,165,56,560,2025-07-22
FC_NJ05,SKU001008,566,167,399,84,840,2025-07-24
FC_NJ05,SKU001801,880,256,624,140,1400,2025-07-24
FC_NJ05,SKU001237,544,153,391,84,840,2025-07-25
FC_NJ05,SKU000011,554,169,385,84,840,2025-07-25
FC_NJ05,SKU001859,570,161,409,84,840,2025-07-26
FC_NJ05,SKU001576,798,260,538,140,1400,2025-07-22
FC_NJ05,SKU000964,1641,494,1147,210,2100,2025-07-21
FC_NJ05,SKU000753,846,254,592,140,1400,2025-07-26
FC_NJ05,SKU001407,820,240,580,140,1400,2025-07-23
FC_NJ05,SKU001623,614,194,420,112,1120,2025-07-27
FC_NJ05,SKU000453,1599,503,1096,210,2100,2025-07-26
FC_NJ05,SKU000918,578,171,407,112,1120,2025-07-22
FC_NJ05,SKU000257,593,189,404,112,1120,2025-07-22
FC_NJ05,SKU001866,1590,461,1129,210,2100,2025-07-23
FC_NJ05,SKU000837,824,254,570,140,1400,2025-07-22
FC_NJ05,SKU000128,651,185,466,112,1120,2025-07-27
FC_NJ05,SKU000797,1591,463,1128,210,2100,2025-07-26
FC_NJ05,SKU000264,823,253,570,140,1400,2025-07-21
FC_NJ05,SKU000350,863,256,607,140,1400,2025-07-27
FC_NJ05,SKU001501,1626,486,1140,210,2100,2025-07-25
FC_NJ05,SKU000027,636,164,472,112,1120,2025-07-23
FC_NJ05,SKU001278,518,141,377,84,840,2025-07-23
FC_NJ05,SKU001306,624,178,446,112,1120,2025-07-24
FC_NJ05,SKU000480,1594,463,1131,210,2100,2025-07-24
FC_NJ05,SKU001968,571,175,396,84,840,2025-07-25
FC_NJ05,SKU001764,1438,437,1001,210,2100,2025-07-23
FC_NJ05,SKU000351,552,175,377,84,840,2025-07-26
FC_NJ05,SKU001203,605,207,398,112,1120,2025-07-25
FC_NJ05,SKU001100,610,183,427,112,1120,2025-07-21
FC_NJ05,SKU001289,607,210,397,112,1120,2025-07-27
FC_NJ05,SKU000812,836,253,583,140,1400,2025-07-23
FC_NJ05,SKU000166,596,184,412,112,1120,2025-07-27
FC_NJ05,SKU000738,246,66,180,56,560,2025-07-21
FC_NJ05,SKU001641,530,157,373,84,840,2025-07-23
FC_NJ05,SKU001572,819,223,596,140,1400,2025-07-27
FC_NJ05,SKU001536,240,72,168,56,560,2025-07-24
FC_NJ05,SKU001698,873,259,614,140,1400,2025-07-25
FC_NJ05,SKU001222,276,78,198,56,560,2025-07-27
FC_NJ05,SKU001367,511,154,357,84,840,2025-07-21
FC_NJ05,SKU000194,588,175,413,112,1120,2025-07-22
FC_NJ05,SKU000089,241,61,180,56,560,2025-07-27
FC_NJ05,SKU000943,532,158,374,84,840,2025-07-24
FC_NJ05,SKU001060,1601,501,1100,210,2100,2025-07-24
FC_NJ05,SKU001086,607,173,434,112,1120,2025-07-21
FC_NJ05,SKU001789,250,91,159,56,560,2025-07-22
FC_NJ05,SKU001063,879,244,635,140,1400,2025-07-26
FC_NJ05,SKU001638,244,67,177,56,560,2025-07-27
FC_NJ05,SKU001961,552,168,384,84,840,2025-07-23
FC_NJ05,SKU001633,531,157,374,84,840,2025-07-26
FC_NJ05,SKU001554,866,246,620,140,1400,2025-07-22
FC_NJ05,SKU000657,646,201,445,112,1120,2025-07-25
FC_NJ05,SKU001159,586,156,430,84,840,2025-07-27
FC_NJ05,SKU000101,636,220,416,112,1120,2025-07-24
FC_NJ05,SKU001365,1522,434,1088,210,2100,2025-07-24
FC_NJ05,SKU001929,530,155,375,84,840,2025-07-22
FC_NJ05,SKU001021,531,162,369,84,840,2025-07-24
FC_NJ05,SKU001614,870,243,627,140,1400,2025-07-26
FC_NJ05,SKU001708,869,280,589,140,1400,2025-07-21
FC_NJ05,SKU001023,864,241,623,140,1400,2025-07-24
FC_NJ05,SKU001510,274,84,190,56,560,2025-07-24
FC_NJ05,SKU000880,547,166,381,84,840,2025-07-26
FC_NJ05,SKU000775,544,149,395,84,840,2025-07-24
FC_NJ05,SKU001545,557,166,391,84,840,2025-07-21
FC_NJ05,SKU001950,847,235,612,140,1400,2025-07-25
FC_NJ05,SKU000656,1493,420,1073,210,2100,2025-07-23
FC_NJ05,SKU000061,599,192,407,112,1120,2025-07-26
FC_NJ05,SKU001433,254,81,173,56,560,2025-07-23
FC_NJ05,SKU000540,879,256,623,140,1400,2025-07-25
FC_NJ05,SKU001271,841,284,557,140,1400,2025-07-21
FC_NJ05,SKU001383,262,75,187,56,560,2025-07-26
FC_NJ05,SKU001061,575,202,373,84,840,2025-07-21
FC_NJ05,SKU001189,599,165,434,112,1120,2025-07-27
FC_NJ05,SKU000876,799,223,576,140,1400,2025-07-22
FC_NJ05,SKU000002,544,159,385,84,840,2025-07-24
FC_NJ05,SKU000843,1592,486,1106,210,2100,2025-07-27
FC_NJ05,SKU001415,214,66,148,56,560,2025-07-22
FC_NJ05,SKU001332,270,91,179,56,560,2025-07-21
FC_NJ05,SKU000781,1545,457,1088,210,2100,2025-07-21
FC_NJ05,SKU001173,538,165,373,84,840,2025-07-21
FC_NJ05,SKU000410,564,158,406,84,840,2025-07-23
FC_NJ05,SKU000815,863,262,601,140,1400,2025-07-26
FC_NJ05,SKU000845,526,161,365,84,840,2025-07-27
FC_NJ05,SKU000818,576,175,401,112,1120,2025-07-21
FC_NJ05,SKU001312,823,243,580,140,1400,2025-07-26
FC_NJ05,SKU001750,1513,453,1060,210,2100,2025-07-26
FC_NJ05,SKU000431,852,264,588,140,1400,2025-07-27
FC_NJ05,SKU001662,1621,487,1134,210,2100,2025-07-22
FC_NJ05,SKU001539,650,183,467,112,1120,2025-07-24
FC_NJ05,SKU000854,1589,528,1061,210,2100,2025-07-26
FC_NJ05,SKU000827,569,193,376,84,840,2025-07-24
FC_NJ05,SKU001646,523,161,362,84,840,2025-07-24
FC_NJ05,SKU000925,238,64,174,56,560,2025-07-23
FC_NJ05,SKU001117,591,178,413,112,1120,2025-07-21
FC_NJ05,SKU000937,262,81,181,56,560,2025-07-22
FC_NJ05,SKU001422,596,159,437,112,1120,2025-07-22
FC_NJ05,SKU001364,574,196,378,84,840,2025-07-23
FC_NJ05,SKU001206,562,155,407,84,840,2025-07-23
FC_NJ05,SKU001951,1608,442,1166,210,2100,2025-07-22
FC_NJ05,SKU000611,810,261,549,140,1400,2025-07-22
FC_NJ05,SKU001471,834,254,580,140,1400,2025-07-27
FC_NJ05,SKU000495,249,68,181,56,560,2025-07-27
FC_NJ05,SKU001674,832,261,571,140,1400,2025-07-22
FC_NJ05,SKU001544,611,184,427,112,1120,2025-07-25
FC_NJ05,SKU001927,530,148,382,84,840,2025-07-21
FC_NJ05,SKU001243,546,150,396,84,840,2025-07-23
FC_NJ05,SKU000026,648,226,422,112,1120,2025-07-24
FC_NJ05,SKU001411,1580,465,1115,210,2100,2025-07-27
FC_NJ05,SKU001755,1496,425,1071,210,2100,2025-07-23
FC_NJ05,SKU001106,1578,457,1121,210,2100,2025-07-23
FC_NJ05,SKU000333,593,181,412,112,1120,2025-07-22
FC_NJ05,SKU001230,585,157,428,112,1120,2025-07-23
FC_NJ05,SKU001520,577,146,431,84,840,2025-07-23
FC_NJ05,SKU001627,879,248,631,140,1400,2025-07-27
FC_NJ05,SKU000462,1642,475,1167,210,2100,2025-07-22
FC_NJ05,SKU001473,520,132,388,84,840,2025-07-23
FC_NJ05,SKU000106,257,82,175,56,560,2025-07-24
FC_NJ05,SKU001919,859,274,585,140,1400,2025-07-24
FC_NJ05,SKU001405,877,237,640,140,1400,2025-07-22
FC_NJ05,SKU000083,843,250,593,140,1400,2025-07-24
FC_NJ05,SKU000154,603,188,415,112,1120,2025-07-21
FC_NJ05,SKU000230,233,80,153,56,560,2025-07-25
FC_NJ05,SKU001715,881,268,613,140,1400,2025-07-21
FC_NJ05,SKU001148,1561,467,1094,210,2100,2025-07-27
FC_NJ05,SKU001975,778,229,549,140,1400,2025-07-23
FC_NJ05,SKU001505,1600,482,1118,210,2100,2025-07-27
FC_NJ05,SKU000280,501,153,348,84,840,2025-07-27
FC_NJ05,SKU000860,876,287,589,140,1400,2025-07-21
FC_NJ05,SKU001453,554,158,396,84,840,2025-07-24
FC_NJ05,SKU001749,278,84,194,56,560,2025-07-27
FC_NJ05,SKU001899,1609,519,1090,210,2100,2025-07-24
FC_NJ05,SKU000304,870,252,618,140,1400,2025-07-27
FC_NJ05,SKU000928,227,61,166,56,560,2025-07-23
FC_NJ05,SKU001096,854,242,612,140,1400,2025-07-22
FC_NJ05,SKU001436,606,208,398,112,1120,2025-07-23
FC_NJ05,SKU000783,555,177,378,84,840,2025-07-23
FC_NJ05,SKU001385,566,164,402,112,1120,2025-07-22
FC_NJ05,SKU001570,600,190,410,112,1120,2025-07-23
FC_NJ05,SKU001234,609,167,442,112,1120,2025-07-27
FC_NJ05,SKU000673,610,173,437,112,1120,2025-07-24
FC_NJ05,SKU000470,547,147,400,84,840,2025-07-26
FC_NJ05,SKU000714,242,72,170,56,560,2025-07-25
FC_NJ05,SKU001113,859,251,608,140,1400,2025-07-22
FC_NJ05,SKU000716,637,200,437,112,1120,2025-07-27
FC_NJ05,SKU001109,607,181,426,112,1120,2025-07-26
FC_NJ05,SKU001504,255,70,185,56,560,2025-07-21
FC_NJ05,SKU001594,852,271,581,140,1400,2025-07-21
FC_NJ05,SKU001540,856,251,605,140,1400,2025-07-27
FC_NJ05,SKU001935,511,157,354,84,840,2025-07-22
FC_NJ05,SKU000743,1542,476,1066,210,2100,2025-07-27
FC_NJ05,SKU001431,535,174,361,84,840,2025-07-25
FC_NJ05,SKU000430,836,223,613,140,1400,2025-07-23
FC_NJ05,SKU001192,837,219,618,140,1400,2025-07-22
FC_NJ05,SKU001455,634,203,431,112,1120,2025-07-22
FC_NJ05,SKU000299,616,184,432,112,1120,2025-07-23
FC_NJ05,SKU001840,571,183,388,84,840,2025-07-23
FC_NJ05,SKU000646,637,200,437,112,1120,2025-07-26
FC_NJ05,SKU000604,1575,483,1092,210,2100,2025-07-24
FC_NJ05,SKU001055,552,193,359,112,1120,2025-07-23
FC_NJ05,SKU000073,615,168,447,112,1120,2025-07-21
FC_NJ05,SKU001357,656,199,457,112,1120,2025-07-24
FC_NJ05,SKU001959,856,252,604,140,1400,2025-07-25
FC_NJ05,SKU000795,858,247,611,140,1400,2025-07-25
FC_NJ05,SKU001677,215,67,148,56,560,2025-07-24
FC_NJ05,SKU001631,821,224,597,140,1400,2025-07-24
FC_NJ05,SKU001095,875,252,623,140,1400,2025-07-26
FC_NJ05,SKU001345,848,275,573,140,1400,2025-07-22
FC_NJ05,SKU000648,1583,485,1098,210,2100,2025-07-22
FC_NJ05,SKU000251,268,81,187,56,560,2025-07-26
FC_NJ05,SKU001074,240,90,150,56,560,2025-07-21
FC_NJ05,SKU001362,498,148,350,84,840,2025-07-21
FC_NJ05,SKU001555,798,244,554,140,1400,2025-07-24
FC_NJ05,SKU000608,1494,453,1041,210,2100,2025-07-27
FC_NJ05,SKU000171,1580,472,1108,210,2100,2025-07-26
FC_NJ05,SKU001131,848,237,611,140,1400,2025-07-24
FC_NJ05,SKU001402,507,157,350,84,840,2025-07-24
FC_NJ05,SKU000915,266,76,190,56,560,2025-07-23
FC_NJ05,SKU000199,631,170,461,112,1120,2025-07-23
FC_NJ05,SKU001401,540,170,370,84,840,2025-07-25
FC_NJ05,SKU001928,615,168,447,112,1120,2025-07-26
FC_NJ05,SKU001873,246,66,180,56,560,2025-07-23
FC_NJ05,SKU001813,809,235,574,140,1400,2025-07-21
FC_NJ05,SKU000573,1620,484,1136,210,2100,2025-07-23
FC_NJ05,SKU001606,832,236,596,140,1400,2025-07-26
FC_NJ05,SKU000435,1576,423,1153,210,2100,2025-07-24
FC_NJ05,SKU001236,625,175,450,112,1120,2025-07-27
FC_NJ05,SKU001358,1599,499,1100,210,2100,2025-07-25
FC_NJ05,SKU000339,885,245,640,140,1400,2025-07-21
FC_NJ05,SKU001759,628,173,455,112,1120,2025-07-27
FC_NJ05,SKU001902,662,206,456,112,1120,2025-07-23
FC_NJ05,SKU000912,241,72,169,56,560,2025-07-26
FC_NJ05,SKU001634,1604,471,1133,210,2100,2025-07-24
FC_NJ05,SKU000201,582,192,390,84,840,2025-07-23
FC_NJ05,SKU000935,1536,457,1079,210,2100,2025-07-22
FC_NJ05,SKU000907,584,188,396,84,840,2025-07-21
FC_NJ05,SKU001532,549,177,372,84,840,2025-07-21
FC_NJ05,SKU000328,874,280,594,140,1400,2025-07-25
FC_NJ05,SKU000671,1606,486,1120,210,2100,2025-07-21
FC_NJ05,SKU000524,887,287,600,140,1400,2025-07-27
FC_NJ05,SKU001007,536,147,389,84,840,2025-07-23
FC_NJ05,SKU000584,640,198,442,112,1120,2025-07-21
FC_NJ05,SKU000676,1536,465,1071,210,2100,2025-07-26
FC_NJ05,SKU000755,540,185,355,84,840,2025-07-26
FC_NJ05,SKU000924,1628,514,1114,210,2100,2025-07-23
FC_NJ05,SKU000334,799,226,573,140,1400,2025-07-26
FC_NJ05,SKU001610,247,63,184,56,560,2025-07-25
FC_NJ05,SKU001102,244,85,159,56,560,2025-07-26
FC_NJ05,SKU000215,853,241,612,140,1400,2025-07-25
FC_NJ05,SKU000613,252,88,164,56,560,2025-07-27
FC_NJ05,SKU000022,834,232,602,140,1400,2025-07-25
FC_NJ05,SKU000680,1598,475,1123,210,2100,2025-07-27
FC_NJ05,SKU000023,618,160,458,112,1120,2025-07-26
FC_NJ05,SKU001823,240,66,174,56,560,2025-07-26
FC_NJ05,SKU001188,804,224,580,140,1400,2025-07-22
FC_NJ05,SKU001044,546,163,383,84,840,2025-07-24
FC_NJ05,SKU000559,595,187,408,84,840,2025-07-26
FC_NJ05,SKU001777,568,148,420,84,840,2025-07-23
FC_NJ05,SKU001999,248,90,158,56,560,2025-07-23
FC_NJ05,SKU001391,536,179,357,84,840,2025-07-23
FC_NJ05,SKU001141,1679,534,1145,210,2100,2025-07-25
FC_NJ05,SKU000747,1548,485,1063,210,2100,2025-07-23
FC_NJ05,SKU000574,1510,459,1051,210,2100,2025-07-27
FC_NJ05,SKU000149,605,182,423,112,1120,2025-07-23
FC_NJ05,SKU001255,877,296,581,140,1400,2025-07-27
FC_NJ05,SKU000489,1623,493,1130,210,2100,2025-07-21
FC_NJ05,SKU001190,241,62,179,56,560,2025-07-23
FC_NJ05,SKU000009,552,162,390,84,840,2025-07-23
FC_NJ05,SKU000658,1564,462,1102,210,2100,2025-07-27
FC_NJ05,SKU001516,839,230,609,140,1400,2025-07-24
FC_NJ05,SKU000243,601,163,438,112,1120,2025-07-21
FC_NJ05,SKU001386,569,166,403,84,840,2025-07-24
FC_NJ05,SKU000855,639,224,415,112,1120,2025-07-26
FC_NJ05,SKU001783,851,246,605,140,1400,2025-07-24
FC_NJ05,SKU001508,851,240,611,140,1400,2025-07-26
FC_NJ05,SKU001408,1596,464,1132,210,2100,2025-07-25
FC_NJ05,SKU001900,542,165,377,84,840,2025-07-22
FC_NJ05,SKU000534,534,156,378,84,840,2025-07-23
FC_NJ05,SKU000920,264,77,187,56,560,2025-07-26
FC_NJ05,SKU000631,601,188,413,112,1120,2025-07-27
FC_NJ05,SKU001417,1520,460,1060,210,2100,2025-07-22
FC_NJ05,SKU000873,584,164,420,112,1120,2025-07-22
FC_NJ05,SKU000337,250,71,179,56,560,2025-07-21
FC_NJ05,SKU000834,603,179,424,112,1120,2025-07-26
FC_NJ05,SKU001265,835,224,611,140,1400,2025-07-25
FC_NJ05,SKU001943,1586,499,1087,210,2100,2025-07-22
FC_NJ05,SKU001499,1558,432,1126,210,2100,2025-07-24
FC_NJ05,SKU001712,615,210,405,112,1120,2025-07-27
FC_NJ05,SKU000405,1593,470,1123,210,2100,2025-07-21
FC_NJ05,SKU001702,671,203,468,112,1120,2025-07-27
FC_NJ05,SKU001318,491,150,341,84,840,2025-07-25
FC_NJ05,SKU001910,1535,454,1081,210,2100,2025-07-22
FC_NJ05,SKU000040,270,86,184,56,560,2025-07-22
FC_NJ05,SKU000610,217,83,134,56,560,2025-07-24
FC_NJ05,SKU000391,1549,509,1040,210,2100,2025-07-22
FC_NJ05,SKU001209,261,76,185,56,560,2025-07-26
FC_NJ05,SKU000060,551,178,373,84,840,2025-07-24
FC_NJ05,SKU000823,851,255,596,140,1400,2025-07-26
FC_NJ05,SKU001290,231,65,166,56,560,2025-07-22
FC_NJ05,SKU000980,254,87,167,56,560,2025-07-26
FC_NJ05,SKU000341,571,162,409,112,1120,2025-07-23
FC_NJ05,SKU000271,605,205,400,112,1120,2025-07-26
FC_NJ05,SKU000986,1562,462,1100,210,2100,2025-07-22
FC_NJ05,SKU001849,247,71,176,56,560,2025-07-21
FC_NJ05,SKU001014,270,75,195,56,560,2025-07-21
FC_NJ05,SKU000290,551,178,373,84,840,2025-07-26
FC_NJ05,SKU000096,1590,457,1133,210,2100,2025-07-21
FC_NJ05,SKU001424,1489,422,1067,210,2100,2025-07-21
FC_NJ05,SKU001325,591,191,400,112,1120,2025-07-22
FC_NJ05,SKU000092,830,230,600,140,1400,2025-07-26
FC_NJ05,SKU001309,233,72,161,56,560,2025-07-24
FC_NJ05,SKU001449,1537,463,1074,210,2100,2025-07-25
FC_NJ05,SKU001146,238,72,166,56,560,2025-07-25
FC_NJ05,SKU000886,267,73,194,56,560,2025-07-25
FC_NJ05,SKU000569,567,146,421,84,840,2025-07-26
FC_NJ05,SKU000447,1576,479,1097,210,2100,2025-07-26
FC_NJ05,SKU001057,567,186,381,84,840,2025-07-24
FC_NJ05,SKU001472,799,258,541,140,1400,2025-07-26
FC_NJ05,SKU001678,246,82,164,56,560,2025-07-24
FC_NJ05,SKU000103,876,274,602,140,1400,2025-07-25
FC_NJ05,SKU001734,600,180,420,112,1120,2025-07-22
FC_NJ05,SKU000733,538,160,378,84,840,2025-07-21
FC_NJ05,SKU000956,891,255,636,140,1400,2025-07-26
FC_NJ05,SKU001228,561,165,396,84,840,2025-07-26
FC_NJ05,SKU001887,281,80,201,56,560,2025-07-24
FC_NJ05,SKU000993,614,205,409,112,1120,2025-07-24
FC_NJ05,SKU000838,881,260,621,140,1400,2025-07-24
FC_NJ05,SKU000148,1583,506,1077,210,2100,2025-07-27
FC_NJ05,SKU001696,244,66,178,56,560,2025-07-27
FC_NJ05,SKU000890,787,242,545,140,1400,2025-07-21
FC_NJ05,SKU001892,249,65,184,56,560,2025-07-26
FC_NJ05,SKU001686,656,196,460,112,1120,2025-07-22
FC_NJ05,SKU001587,241,84,157,56,560,2025-07-25
FC_NJ05,SKU001604,260,70,190,56,560,2025-07-26
FC_NJ05,SKU001655,590,179,411,112,1120,2025-07-26
FC_NJ05,SKU000627,532,151,381,84,840,2025-07-27
FC_NJ05,SKU000059,543,177,366,84,840,2025-07-27
FC_NJ05,SKU001506,633,192,441,112,1120,2025-07-21
FC_NJ05,SKU000998,808,258,550,140,1400,2025-07-23
FC_NJ05,SKU001931,475,132,343,84,840,2025-07-21
FC_NJ05,SKU000545,614,166,448,112,1120,2025-07-23
FC_NJ05,SKU000068,1544,454,1090,210,2100,2025-07-24
FC_NJ05,SKU001639,1547,415,1132,210,2100,2025-07-27
FC_NJ05,SKU000108,1636,534,1102,210,2100,2025-07-22
FC_NJ05,SKU001645,862,272,590,140,1400,2025-07-23
FC_NJ05,SKU001207,884,247,637,140,1400,2025-07-21
FC_NJ05,SKU001621,243,77,166,56,560,2025-07-21
FC_NJ05,SKU000233,609,166,443,112,1120,2025-07-27
FC_NJ05,SKU001111,862,255,607,140,1400,2025-07-23
FC_NJ05,SKU001084,537,177,360,84,840,2025-07-23
FC_NJ05,SKU001585,1619,450,1169,210,2100,2025-07-24
FC_NJ05,SKU000526,232,68,164,56,560,2025-07-22
FC_NJ05,SKU000445,864,270,594,140,1400,2025-07-27
FC_NJ05,SKU000499,637,183,454,112,1120,2025-07-26
FC_NJ05,SKU001978,873,276,597,140,1400,2025-07-22
FC_NJ05,SKU000484,849,249,600,140,1400,2025-07-24
FC_NJ05,SKU001015,237,76,161,56,560,2025-07-24
FC_NJ05,SKU000824,1548,497,1051,210,2100,2025-07-21
FC_NJ05,SKU000292,565,188,377,84,840,2025-07-23
FC_NJ05,SKU000806,557,172,385,84,840,2025-07-23
FC_NJ05,SKU000298,654,211,443,112,1120,2025-07-21
FC_NJ05,SKU000705,223,71,152,56,560,2025-07-23
FC_NJ05,SKU001258,640,166,474,112,1120,2025-07-27
FC_NJ05,SKU000177,633,209,424,112,1120,2025-07-21
FC_NJ05,SKU000946,251,72,179,56,560,2025-07-23
FC_NJ05,SKU001683,274,75,199,56,560,2025-07-25
FC_NJ05,SKU000100,506,165,341,84,840,2025-07-24
FC_NJ05,SKU001274,1690,511,1179,210,2100,2025-07-23
FC_NJ05,SKU001659,546,150,396,84,840,2025-07-22
FC_NJ05,SKU000788,1596,445,1151,210,2100,2025-07-24
FC_NJ05,SKU000973,248,63,185,56,560,2025-07-26
FC_NJ05,SKU001297,842,246,596,140,1400,2025-07-23
FC_NJ05,SKU001191,572,185,387,84,840,2025-07-22
FC_NJ05,SKU000212,865,278,587,140,1400,2025-07-22
FC_NJ05,SKU002000,559,149,410,84,840,2025-07-27
FC_NJ05,SKU000117,815,221,594,140,1400,2025-07-25
FC_NJ05,SKU000259,1547,449,1098,210,2100,2025-07-21
FC_NJ05,SKU001701,903,256,647,140,1400,2025-07-24
FC_NJ05,SKU000629,1637,475,1162,210,2100,2025-07-27
FC_NJ05,SKU001437,563,180,383,84,840,2025-07-27
FC_NJ05,SKU001292,674,207,467,112,1120,2025-07-27
FC_NJ05,SKU000363,593,183,410,112,1120,2025-07-22
FC_NJ05,SKU001256,243,79,164,56,560,2025-07-27
FC_NJ05,SKU000921,580,180,400,84,840,2025-07-27
FC_NJ05,SKU001685,1580,472,1108,210,2100,2025-07-25
FC_NJ05,SKU001700,575,175,400,84,840,2025-07-27
FC_NJ05,SKU001562,614,185,429,112,1120,2025-07-27
FC_NJ05,SKU001857,251,70,181,56,560,2025-07-26
FC_NJ05,SKU000740,506,167,339,84,840,2025-07-23
FC_NJ05,SKU000690,604,201,403,112,1120,2025-07-22
FC_NJ05,SKU001895,626,189,437,112,1120,2025-07-23
FC_NJ05,SKU000659,241,97,144,56,560,2025-07-22
FC_NJ05,SKU001038,1561,508,1053,210,2100,2025-07-26
FC_NJ05,SKU001718,556,159,397,84,840,2025-07-27
FC_NJ05,SKU001241,572,186,386,112,1120,2025-07-21
FC_NJ05,SKU001788,251,77,174,56,560,2025-07-22
FC_NJ05,SKU000497,1580,476,1104,210,2100,2025-07-27
FC_NJ05,SKU001491,259,73,186,56,560,2025-07-23
FC_NJ05,SKU000588,881,255,626,140,1400,2025-07-27
FC_NJ05,SKU001324,628,201,427,112,1120,2025-07-27
FC_NJ05,SKU001740,569,176,393,84,840,2025-07-25
FC_NJ05,SKU001682,841,252,589,140,1400,2025-07-23
FC_NJ05,SKU000234,568,162,406,84,840,2025-07-22
FC_NJ05,SKU000476,594,162,432,84,840,2025-07-21
FC_NJ05,SKU001232,1591,464,1127,210,2100,2025-07-26
FC_NJ05,SKU001541,1688,477,1211,210,2100,2025-07-23
FC_NJ05,SKU001705,292,89,203,56,560,2025-07-21
FC_NJ05,SKU001174,572,157,415,84,840,2025-07-24
FC_NJ05,SKU001912,864,233,631,140,1400,2025-07-26
FC_NJ05,SKU000160,257,83,174,56,560,2025-07-26
FC_NJ05,SKU000742,251,54,197,56,560,2025-07-27
FC_NJ05,SKU001353,805,239,566,140,1400,2025-07-26
FC_NJ05,SKU001862,278,86,192,56,560,2025-07-23
FC_NJ05,SKU000019,1573,483,1090,210,2100,2025-07-21
FC_NJ05,SKU000685,539,184,355,84,840,2025-07-23
FC_NJ05,SKU000552,1535,457,1078,210,2100,2025-07-27
FC_NJ05,SKU000791,594,185,409,112,1120,2025-07-21
FC_NJ05,SKU001907,1638,472,1166,210,2100,2025-07-25
FC_NJ05,SKU001725,558,173,385,84,840,2025-07-21
FC_NJ05,SKU001775,651,178,473,112,1120,2025-07-27
FC_NJ05,SKU000008,1584,500,1084,210,2100,2025-07-24
FC_NJ05,SKU001446,262,66,196,56,560,2025-07-27
FC_NJ05,SKU000225,757,209,548,140,1400,2025-07-25
FC_NJ05,SKU000829,865,258,607,140,1400,2025-07-26
FC_NJ05,SKU000875,233,73,160,56,560,2025-07-21
FC_NJ05,SKU001107,637,179,458,112,1120,2025-07-26
FC_NJ05,SKU000137,1618,488,1130,210,2100,2025-07-25
FC_NJ05,SKU000979,889,272,617,140,1400,2025-07-27
FC_NJ05,SKU000414,515,153,362,84,840,2025-07-25
FC_NJ05,SKU000382,626,198,428,112,1120,2025-07-24
FC_NJ05,SKU000502,833,243,590,140,1400,2025-07-24
FC_NJ05,SKU001824,621,187,434,112,1120,2025-07-24
FC_NJ05,SKU001430,1624,512,1112,210,2100,2025-07-21
FC_NJ05,SKU000269,255,78,177,56,560,2025-07-22
FC_NJ05,SKU001616,222,78,144,56,560,2025-07-27
FC_NJ05,SKU000902,290,99,191,56,560,2025-07-25
FC_NJ05,SKU001981,239,54,185,56,560,2025-07-21
FC_NJ05,SKU001909,1605,492,1113,210,2100,2025-07-21
FC_NJ05,SKU001993,548,179,369,84,840,2025-07-22
FC_NJ05,SKU000721,595,185,410,112,1120,2025-07-25
FC_NJ05,SKU001727,877,259,618,140,1400,2025-07-24
FC_NJ05,SKU001947,507,144,363,84,840,2025-07-23
FC_NJ05,SKU001599,631,181,450,112,1120,2025-07-26
FC_NJ05,SKU000868,826,235,591,140,1400,2025-07-23
FC_NJ05,SKU000869,567,166,401,84,840,2025-07-24
FC_NJ05,SKU000455,529,155,374,84,840,2025-07-25
FC_NJ05,SKU001884,517,158,359,84,840,2025-07-26
FC_NJ05,SKU001547,1576,447,1129,210,2100,2025-07-23
FC_NJ05,SKU000152,263,69,194,56,560,2025-07-21
FC_NJ05,SKU000884,623,193,430,112,1120,2025-07-22
FC_NJ05,SKU000155,1663,506,1157,210,2100,2025-07-27
FC_NJ05,SKU001212,836,255,581,140,1400,2025-07-21
FC_NJ05,SKU001827,799,245,554,140,1400,2025-07-27
FC_NJ05,SKU001112,236,85,151,56,560,2025-07-26
FC_NJ05,SKU001497,594,149,445,112,1120,2025-07-22
FC_NJ05,SKU001538,834,253,581,140,1400,2025-07-25
FC_NJ05,SKU001699,244,72,172,56,560,2025-07-27
FC_NJ05,SKU001974,559,152,407,84,840,2025-07-24
FC_NJ05,SKU000614,638,201,437,112,1120,2025-07-23
FC_NJ05,SKU001012,225,72,153,56,560,2025-07-23
FC_NJ05,SKU000737,1520,430,1090,210,2100,2025-07-21
FC_NJ05,SKU001817,561,158,403,84,840,2025-07-22
FC_NJ05,SKU000666,823,263,560,140,1400,2025-07-22
FC_NJ05,SKU001481,1627,469,1158,210,2100,2025-07-26
FC_NJ05,SKU000547,849,250,599,140,1400,2025-07-23
FC_NJ05,SKU000708,855,251,604,140,1400,2025-07-26
FC_NJ05,SKU000746,856,250,606,140,1400,2025-07-25
FC_NJ05,SKU001648,235,71,164,56,560,2025-07-22
FC_NJ05,SKU001460,251,83,168,56,560,2025-07-22
FC_NJ05,SKU001976,258,85,173,56,560,2025-07-25
FC_NJ05,SKU001341,844,256,588,140,1400,2025-07-23
FC_NJ05,SKU001766,555,189,366,84,840,2025-07-26
FC_NJ05,SKU000600,854,281,573,140,1400,2025-07-22
FC_NJ05,SKU000999,788,231,557,140,1400,2025-07-23
FC_NJ05,SKU001612,555,171,384,84,840,2025-07-21
FC_NJ05,SKU001918,826,261,565,140,1400,2025-07-22
FC_NJ05,SKU000822,233,66,167,56,560,2025-07-24
FC_NJ05,SKU001487,516,151,365,84,840,2025-07-23
FC_NJ05,SKU000899,503,147,356,84,840,2025-07-24
FC_NJ05,SKU001382,251,77,174,56,560,2025-07-21
FC_NJ05,SKU000693,268,80,188,56,560,2025-07-25
FC_NJ05,SKU000867,558,169,389,84,840,2025-07-25
FC_NJ05,SKU000955,535,178,357,84,840,2025-07-23
FC_NJ05,SKU001049,515,143,372,84,840,2025-07-27
FC_NJ05,SKU001829,1521,461,1060,210,2100,2025-07-22
FC_NJ05,SKU000268,252,72,180,56,560,2025-07-26
FC_NJ05,SKU001263,865,244,621,140,1400,2025-07-26
FC_NJ05,SKU001281,1562,484,1078,210,2100,2025-07-26
FC_NJ05,SKU000941,264,69,195,56,560,2025-07-25
FC_NJ05,SKU001404,1567,445,1122,210,2100,2025-07-26
FC_NJ05,SKU001831,789,254,535,140,1400,2025-07-22
FC_NJ05,SKU000865,1514,436,1078,210,2100,2025-07-26
FC_NJ05,SKU000931,674,201,473,112,1120,2025-07-26
FC_NJ05,SKU001465,791,228,563,140,1400,2025-07-26
FC_NJ05,SKU001979,539,162,377,84,840,2025-07-22
FC_NJ05,SKU001238,572,180,392,84,840,2025-07-27
FC_NJ05,SKU001657,1542,451,1091,210,2100,2025-07-27
FC_NJ05,SKU000820,1615,475,1140,210,2100,2025-07-24
FC_NJ05,SKU000248,1560,465,1095,210,2100,2025-07-25
FC_NJ05,SKU001868,539,151,388,84,840,2025-07-21
FC_NJ05,SKU000254,821,252,569,140,1400,2025-07-25
FC_NJ05,SKU000388,592,171,421,112,1120,2025-07-23
FC_NJ05,SKU001977,621,185,436,112,1120,2025-07-24
FC_NJ05,SKU001208,845,264,581,140,1400,2025-07-25
FC_NJ05,SKU000016,627,186,441,112,1120,2025-07-25
FC_NJ05,SKU001625,856,263,593,140,1400,2025-07-26
FC_NJ05,SKU001080,274,88,186,56,560,2025-07-24
FC_NJ05,SKU000660,629,171,458,112,1120,2025-07-21
FC_NJ05,SKU000139,1503,445,1058,210,2100,2025-07-25
FC_NJ05,SKU001780,522,164,358,84,840,2025-07-27
FC_NJ05,SKU000065,504,146,358,84,840,2025-07-23
FC_NJ05,SKU001566,1525,454,1071,210,2100,2025-07-24
FC_NJ05,SKU001903,262,73,189,56,560,2025-07-27
FC_NJ05,SKU001139,1547,449,1098,210,2100,2025-07-26
FC_NJ05,SKU001658,592,181,411,112,1120,2025-07-27
FC_NJ05,SKU000521,588,167,421,112,1120,2025-07-26
FC_NJ05,SKU001081,1571,465,1106,210,2100,2025-07-22
FC_NJ05,SKU000771,1557,493,1064,210,2100,2025-07-26
FC_NJ05,SKU000353,1572,461,1111,210,2100,2025-07-24
FC_NJ05,SKU001090,244,67,177,56,560,2025-07-25
FC_NJ05,SKU001488,850,262,588,140,1400,2025-07-22
FC_NJ05,SKU000494,541,183,358,84,840,2025-07-22
FC_NJ05,SKU000914,260,73,187,56,560,2025-07-27
FC_NJ05,SKU001445,633,169,464,112,1120,2025-07-22
FC_NJ05,SKU001389,531,157,374,84,840,2025-07-27
FC_NJ05,SKU000182,1608,479,1129,210,2100,2025-07-26
FC_NJ05,SKU000491,599,182,417,84,840,2025-07-23
FC_NJ05,SKU000202,591,183,408,112,1120,2025-07-25
FC_NJ05,SKU001695,609,183,426,112,1120,2025-07-21
FC_NJ05,SKU000448,624,194,430,112,1120,2025-07-24
FC_NJ05,SKU000983,1559,451,1108,210,2100,2025-07-23
FC_NJ05,SKU001315,842,244,598,140,1400,2025-07-21
FC_NJ05,SKU000134,1592,478,1114,210,2100,2025-07-27
FC_NJ05,SKU000392,604,185,419,112,1120,2025-07-21
FC_NJ05,SKU001936,1602,476,1126,210,2100,2025-07-22
FC_NJ05,SKU000146,1585,486,1099,210,2100,2025-07-21
FC_NJ05,SKU001398,557,155,402,84,840,2025-07-21
FC_NJ05,SKU001736,612,154,458,112,1120,2025-07-21
FC_NJ05,SKU001635,521,165,356,84,840,2025-07-26
FC_NJ05,SKU001667,679,216,463,112,1120,2025-07-26
FC_NJ05,SKU000042,1640,488,1152,210,2100,2025-07-27
FC_NJ05,SKU000076,813,247,566,140,1400,2025-07-23
FC_NJ05,SKU000213,246,65,181,56,560,2025-07-22
FC_NJ05,SKU001848,885,252,633,140,1400,2025-07-27
FC_NJ05,SKU001722,220,63,157,56,560,2025-07-22
FC_NJ05,SKU000336,518,152,366,84,840,2025-07-25
FC_NJ05,SKU001016,517,141,376,84,840,2025-07-23
FC_NJ05,SKU000978,577,155,422,84,840,2025-07-26
FC_NJ05,SKU000384,272,90,182,56,560,2025-07-24
FC_NJ05,SKU001124,631,186,445,112,1120,2025-07-21
FC_NJ05,SKU000478,616,181,435,112,1120,2025-07-27
FC_NJ05,SKU001600,846,253,593,140,1400,2025-07-26
FC_NJ05,SKU000446,1507,426,1081,210,2100,2025-07-21
FC_NJ05,SKU000761,598,166,432,112,1120,2025-07-23
FC_NJ05,SKU001058,244,78,166,56,560,2025-07-23
FC_NJ05,SKU000813,579,187,392,84,840,2025-07-23
FC_NJ05,SKU000111,242,71,171,56,560,2025-07-24
FC_NJ05,SKU000989,631,214,417,112,1120,2025-07-21
FC_NJ05,SKU000962,547,161,386,84,840,2025-07-27
FC_NJ05,SKU000729,873,247,626,140,1400,2025-07-22
FC_NJ05,SKU001296,636,201,435,112,1120,2025-07-23
FC_NJ05,SKU001013,240,58,182,56,560,2025-07-23
FC_NJ05,SKU000550,899,280,619,140,1400,2025-07-22
FC_NJ05,SKU001482,818,242,576,140,1400,2025-07-22
FC_NJ05,SKU001033,840,274,566,140,1400,2025-07-26
FC_NJ05,SKU000188,555,158,397,84,840,2025-07-24
FC_NJ05,SKU001182,870,262,608,140,1400,2025-07-24
FC_NJ05,SKU001354,529,177,352,84,840,2025-07-25
FC_NJ05,SKU001611,893,272,621,140,1400,2025-07-24
FC_NJ05,SKU000603,501,145,356,84,840,2025-07-25
FC_NJ05,SKU000138,627,200,427,112,1120,2025-07-24
FC_NJ05,SKU000667,244,71,173,56,560,2025-07-24
FC_NJ05,SKU001842,583,174,409,112,1120,2025-07-26
FC_NJ05,SKU001277,836,219,617,140,1400,2025-07-22
FC_NJ05,SKU000419,657,187,470,112,1120,2025-07-26
FC_NJ05,SKU001830,245,73,172,56,560,2025-07-27
FC_NJ05,SKU000959,265,72,193,56,560,2025-07-26
FC_NJ05,SKU001605,773,245,528,140,1400,2025-07-23
FC_NJ05,SKU001108,239,63,176,56,560,2025-07-24
FC_NJ05,SKU001171,1564,495,1069,210,2100,2025-07-24
FC_NJ05,SKU001323,871,254,617,140,1400,2025-07-26
FC_NJ05,SKU001785,1588,495,1093,210,2100,2025-07-26
FC_NJ05,SKU000320,1535,436,1099,210,2100,2025-07-21
FC_NJ05,SKU001259,881,262,619,140,1400,2025-07-26
FC_NJ05,SKU001704,617,181,436,112,1120,2025-07-24
FC_NJ05,SKU001525,1565,449,1116,210,2100,2025-07-21
FC_NJ05,SKU000474,820,263,557,140,1400,2025-07-25
FC_NJ05,SKU001288,543,168,375,84,840,2025-07-25
FC_NJ05,SKU000967,840,238,602,140,1400,2025-07-27
FC_NJ05,SKU000017,598,188,410,84,840,2025-07-25
FC_NJ05,SKU001847,570,196,374,84,840,2025-07-26
FC_NJ05,SKU001264,253,71,182,56,560,2025-07-27
FC_NJ05,SKU000427,835,270,565,140,1400,2025-07-24
FC_NJ05,SKU000224,263,74,189,56,560,2025-07-22
FC_NJ05,SKU001125,570,178,392,112,1120,2025-07-21
FC_NJ05,SKU001944,1506,429,1077,210,2100,2025-07-25
FC_NJ05,SKU001679,1506,440,1066,210,2100,2025-07-22
FC_NJ05,SKU001233,604,188,416,112,1120,2025-07-23
FC_NJ05,SKU001377,1578,470,1108,210,2100,2025-07-26
FC_NJ05,SKU001548,855,268,587,140,1400,2025-07-26
FC_NJ05,SKU000704,545,151,394,84,840,2025-07-27
FC_NJ05,SKU000991,839,221,618,140,1400,2025-07-23
FC_NJ05,SKU000309,525,176,349,84,840,2025-07-23
FC_NJ05,SKU000982,263,79,184,56,560,2025-07-26
FC_NJ05,SKU000444,519,170,349,84,840,2025-07-25
FC_NJ05,SKU000670,530,153,377,84,840,2025-07-22
FC_NJ05,SKU001825,552,167,385,84,840,2025-07-27
FC_NJ05,SKU000441,233,52,181,56,560,2025-07-22
FC_NJ05,SKU001665,548,162,386,84,840,2025-07-24
FC_NJ05,SKU000424,571,150,421,112,1120,2025-07-23
FC_NJ05,SKU000004,1558,446,1112,210,2100,2025-07-21
FC_NJ05,SKU001498,624,203,421,112,1120,2025-07-27
FC_NJ05,SKU000250,607,173,434,112,1120,2025-07-26
FC_NJ05,SKU001319,240,70,170,56,560,2025-07-27
FC_NJ05,SKU000411,855,244,611,140,1400,2025-07-26
FC_NJ05,SKU000175,591,180,411,112,1120,2025-07-27
FC_NJ05,SKU001287,523,167,356,84,840,2025-07-21
FC_NJ05,SKU001300,610,194,416,112,1120,2025-07-21
FC_NJ05,SKU001466,545,165,380,84,840,2025-07-23
FC_NJ05,SKU001280,1566,424,1142,210,2100,2025-07-27
FC_NJ05,SKU000877,1611,446,1165,210,2100,2025-07-21
FC_NJ05,SKU001517,254,81,173,56,560,2025-07-23
FC_NJ05,SKU001871,820,262,558,140,1400,2025-07-22
FC_NJ05,SKU001110,258,77,181,56,560,2025-07-22
FC_NJ05,SKU001949,1574,444,1130,210,2100,2025-07-25
FC_NJ05,SKU000802,498,137,361,84,840,2025-07-23
FC_NJ05,SKU001335,792,270,522,140,1400,2025-07-24
FC_NJ05,SKU001363,274,89,185,56,560,2025-07-27
FC_NJ05,SKU001247,864,242,622,140,1400,2025-07-22
FC_NJ05,SKU000179,236,76,160,56,560,2025-07-25
FC_NJ05,SKU001164,1609,555,1054,210,2100,2025-07-26
FC_NJ05,SKU000841,266,72,194,56,560,2025-07-26
FC_NJ05,SKU000045,260,74,186,56,560,2025-07-21
FC_NJ05,SKU001476,521,153,368,84,840,2025-07-21
FC_NJ05,SKU000934,530,161,369,84,840,2025-07-23
FC_NJ05,SKU000954,853,231,622,140,1400,2025-07-25
FC_NJ05,SKU000070,1582,469,1113,210,2100,2025-07-23
FC_NJ05,SKU001368,598,183,415,112,1120,2025-07-23
FC_NJ05,SKU001248,612,177,435,112,1120,2025-07-24
FC_NJ05,SKU000281,1592,431,1161,210,2100,2025-07-22
FC_NJ05,SKU001891,262,50,212,56,560,2025-07-23
FC_NJ05,SKU001002,868,251,617,140,1400,2025-07-23
FC_NJ05,SKU000984,623,181,442,112,1120,2025-07-24
FC_NJ05,SKU001569,605,214,391,112,1120,2025-07-26
FC_NJ05,SKU001423,835,246,589,140,1400,2025-07-22
FC_NJ05,SKU000972,538,159,379,84,840,2025-07-27
FC_NJ05,SKU000094,1555,464,1091,210,2100,2025-07-24
FC_NJ05,SKU000724,555,176,379,84,840,2025-07-24
FC_NJ05,SKU000238,1574,458,1116,210,2100,2025-07-23
FC_NJ05,SKU000226,257,76,181,56,560,2025-07-26
FC_NJ05,SKU000003,651,204,447,112,1120,2025-07-23
FC_NJ05,SKU001366,1585,500,1085,210,2100,2025-07-27
FC_NJ05,SKU001037,579,192,387,112,1120,2025-07-23
FC_NJ05,SKU001946,815,247,568,140,1400,2025-07-27
FC_NJ05,SKU000807,234,78,156,56,560,2025-07-24
FC_NJ05,SKU000197,1557,477,1080,210,2100,2025-07-21
FC_NJ05,SKU001494,653,201,452,112,1120,2025-07-22
FC_NJ05,SKU001877,853,263,590,140,1400,2025-07-23
FC_NJ05,SKU000538,815,243,572,140,1400,2025-07-25
FC_NJ05,SKU001713,576,155,421,112,1120,2025-07-22
FC_NJ05,SKU000908,523,165,358,84,840,2025-07-21
FC_NJ05,SKU001579,268,74,194,56,560,2025-07-21
FC_NJ05,SKU000585,240,66,174,56,560,2025-07-24
FC_NJ05,SKU000486,1534,465,1069,210,2100,2025-07-23
FC_NJ05,SKU000349,633,206,427,112,1120,2025-07-23
FC_NJ05,SKU001185,583,200,383,112,1120,2025-07-21
FC_NJ05,SKU000258,1616,490,1126,210,2100,2025-07-27
FC_NJ05,SKU001982,864,259,605,140,1400,2025-07-21
FC_NJ05,SKU000701,1566,468,1098,210,2100,2025-07-27
FC_NJ05,SKU001227,1553,470,1083,210,2100,2025-07-22
FC_NJ05,SKU000048,294,79,215,56,560,2025-07-27
FC_NJ05,SKU000277,878,257,621,140,1400,2025-07-22
FC_NJ05,SKU000432,232,68,164,56,560,2025-07-22
FC_NJ05,SKU000756,547,164,383,84,840,2025-07-24
FC_NJ05,SKU000997,234,68,166,56,560,2025-07-26
FC_NJ05,SKU000156,243,73,170,56,560,2025-07-25
FC_NJ05,SKU000131,261,83,178,56,560,2025-07-26
FC_NJ05,SKU001220,1522,467,1055,210,2100,2025-07-26
FC_NJ05,SKU000864,567,182,385,84,840,2025-07-26
FC_NJ05,SKU001399,610,192,418,112,1120,2025-07-27
FC_NJ05,SKU000898,632,204,428,112,1120,2025-07-23
FC_NJ05,SKU001650,868,228,640,140,1400,2025-07-21
FC_NJ05,SKU001153,565,155,410,84,840,2025-07-23
FC_NJ05,SKU000395,840,266,574,140,1400,2025-07-22
FC_NJ05,SKU000551,799,260,539,140,1400,2025-07-26
FC_NJ05,SKU000375,1530,500,1030,210,2100,2025-07-23
FC_NJ05,SKU000557,551,185,366,84,840,2025-07-24
FC_NJ05,SKU001670,550,172,378,84,840,2025-07-21
FC_NJ05,SKU001199,251,74,177,56,560,2025-07-23
FC_NJ05,SKU000844,815,259,556,140,1400,2025-07-26
FC_NJ05,SKU000130,232,59,173,56,560,2025-07-25
FC_NJ05,SKU000963,830,255,575,140,1400,2025-07-21
FC_NJ05,SKU001906,552,164,388,84,840,2025-07-23
FC_NJ05,SKU001934,1553,441,1112,210,2100,2025-07-26
FC_NJ05,SKU001126,501,152,349,84,840,2025-07-26
FC_NJ05,SKU001748,558,158,400,84,840,2025-07-27
FC_NJ05,SKU000186,634,201,433,112,1120,2025-07-24
FC_NJ05,SKU001030,648,187,461,112,1120,2025-07-27
FC_NJ05,SKU001804,553,158,395,84,840,2025-07-22
FC_NJ05,SKU000053,611,188,423,84,840,2025-07-24
FC_NJ05,SKU000624,855,232,623,140,1400,2025-07-22
FC_NJ05,SKU000809,605,204,401,112,1120,2025-07-25
FC_NJ05,SKU000479,817,235,582,140,1400,2025-07-27
FC_NJ05,SKU001154,1552,440,1112,210,2100,2025-07-27
FC_NJ05,SKU001586,1585,479,1106,210,2100,2025-07-22
FC_NJ05,SKU001079,242,77,165,56,560,2025-07-27
FC_NJ05,SKU000219,259,68,191,56,560,2025-07-24
FC_NJ05,SKU000282,619,201,418,112,1120,2025-07-24
FC_NJ05,SKU000464,232,66,166,56,560,2025-07-21
FC_NJ05,SKU000387,1630,443,1187,210,2100,2025-07-22
FC_NJ05,SKU001932,853,256,597,140,1400,2025-07-21
FC_NJ05,SKU000764,605,176,429,112,1120,2025-07-27
FC_NJ05,SKU000114,226,86,140,56,560,2025-07-24
FC_NJ05,SKU000159,825,234,591,140,1400,2025-07-26
FC_NJ05,SKU000635,508,142,366,84,840,2025-07-25
FC_NJ05,SKU001158,592,207,385,112,1120,2025-07-24
FC_NJ05,SKU000236,847,245,602,140,1400,2025-07-27
FC_NJ05,SKU000081,544,151,393,84,840,2025-07-25
FC_NJ05,SKU000189,234,86,148,56,560,2025-07-22
FC_NJ05,SKU001370,914,266,648,140,1400,2025-07-27
FC_NJ05,SKU000933,538,147,391,84,840,2025-07-24
FC_NJ05,SKU001115,858,255,603,140,1400,2025-07-21
FC_NJ05,SKU000244,1552,517,1035,210,2100,2025-07-25
FC_NJ05,SKU000560,247,69,178,56,560,2025-07-25
FC_NJ05,SKU001285,244,71,173,56,560,2025-07-27
FC_NJ05,SKU001198,830,277,553,140,1400,2025-07-24
FC_NJ05,SKU000825,246,87,159,56,560,2025-07-25
FC_NJ05,SKU001971,508,172,336,84,840,2025-07-23
FC_NJ05,SKU001041,672,210,462,112,1120,2025-07-24
FC_NJ05,SKU000369,825,268,557,140,1400,2025-07-21
FC_NJ05,SKU001352,835,255,580,140,1400,2025-07-22
FC_NJ05,SKU000655,1558,477,1081,210,2100,2025-07-21
FC_NJ05,SKU001580,515,159,356,84,840,2025-07-26
FC_NJ05,SKU001004,573,182,391,84,840,2025-07-25
FC_NJ05,SKU000840,848,258,590,140,1400,2025-07-23
FC_NJ05,SKU000195,825,244,581,140,1400,2025-07-27
FC_NJ05,SKU001815,864,283,581,140,1400,2025-07-26
FC_NJ05,SKU001308,567,195,372,84,840,2025-07-26
FC_NJ05,SKU000595,1634,522,1112,210,2100,2025-07-22
FC_NJ05,SKU000760,827,221,606,140,1400,2025-07-22
FC_NJ05,SKU001694,267,91,176,56,560,2025-07-25
FC_NJ05,SKU000539,604,144,460,112,1120,2025-07-26
FC_NJ05,SKU001743,857,256,601,140,1400,2025-07-24
FC_NJ05,SKU000720,1521,470,1051,210,2100,2025-07-21
FC_NJ05,SKU000129,663,177,486,112,1120,2025-07-22
FC_NJ05,SKU000052,248,70,178,56,560,2025-07-23
FC_NJ05,SKU001087,247,74,173,56,560,2025-07-25
FC_NJ05,SKU001373,251,72,179,56,560,2025-07-24
FC_NJ05,SKU001140,893,275,618,140,1400,2025-07-22
FC_NJ05,SKU001716,795,237,558,140,1400,2025-07-22
FC_NJ05,SKU000342,619,197,422,112,1120,2025-07-23
FC_NJ05,SKU001814,808,240,568,140,1400,2025-07-26
FC_NJ05,SKU001637,576,174,402,112,1120,2025-07-23
FC_NJ05,SKU000751,619,180,439,112,1120,2025-07-25
FC_NJ05,SKU001784,634,192,442,112,1120,2025-07-24
FC_NJ05,SKU001056,774,221,553,140,1400,2025-07-24
FC_NJ05,SKU000507,1578,459,1119,210,2100,2025-07-27
FC_NJ05,SKU001732,1551,429,1122,210,2100,2025-07-25
FC_NJ05,SKU001543,528,141,387,84,840,2025-07-24
FC_NJ05,SKU000506,630,213,417,112,1120,2025-07-21
FC_NJ05,SKU000575,885,288,597,140,1400,2025-07-24
FC_NJ05,SKU001632,546,165,381,84,840,2025-07-21
FC_NJ05,SKU001175,814,233,581,140,1400,2025-07-26
FC_NJ05,SKU000529,561,186,375,84,840,2025-07-27
FC_NJ05,SKU001803,1642,456,1186,210,2100,2025-07-24
FC_NJ05,SKU001573,610,156,454,112,1120,2025-07-27
FC_NJ05,SKU000821,572,161,411,84,840,2025-07-22
FC_NJ05,SKU000582,869,263,606,140,1400,2025-07-25
FC_NJ05,SKU000793,259,88,171,56,560,2025-07-24
FC_NJ05,SKU000858,539,155,384,84,840,2025-07-26
FC_NJ05,SKU001994,833,210,623,140,1400,2025-07-26
FC_NJ05,SKU000510,1593,455,1138,210,2100,2025-07-26
FC_NJ05,SKU001160,527,154,373,84,840,2025-07-22
FC_NJ05,SKU001003,1514,437,1077,210,2100,2025-07-23
FC_NJ05,SKU000401,819,250,569,140,1400,2025-07-25
FC_NJ05,SKU001412,543,142,401,84,840,2025-07-26
FC_NJ05,SKU001962,496,145,351,84,840,2025-07-26
FC_NJ05,SKU001359,571,194,377,84,840,2025-07-27
FC_NJ05,SKU000744,862,271,591,140,1400,2025-07-23
FC_NJ05,SKU001120,260,71,189,56,560,2025-07-27
FC_NJ05,SKU001123,243,78,165,56,560,2025-07-21
FC_NJ05,SKU000141,1592,464,1128,210,2100,2025-07-26
FC_NJ05,SKU000647,227,78,149,56,560,2025-07-24
FC_NJ05,SKU000878,613,197,416,112,1120,2025-07-21
FC_NJ05,SKU001890,602,190,412,112,1120,2025-07-25
FC_NJ05,SKU000520,537,174,363,84,840,2025-07-23
FC_NJ05,SKU001394,1592,503,1089,210,2100,2025-07-27
FC_NJ05,SKU000597,535,166,369,84,840,2025-07-21
FC_NJ05,SKU001922,861,245,616,140,1400,2025-07-25
FC_NJ05,SKU001908,1535,486,1049,210,2100,2025-07-26
FC_NJ05,SKU000894,631,201,430,112,1120,2025-07-23
FC_NJ05,SKU000927,493,146,347,84,840,2025-07-25
FC_NJ05,SKU001145,558,174,384,84,840,2025-07-26
FC_NJ05,SKU000216,1586,462,1124,210,2100,2025-07-24
FC_NJ05,SKU000607,580,175,405,84,840,2025-07-21
FC_NJ05,SKU001853,532,168,364,84,840,2025-07-21
FC_NJ05,SKU000192,1547,475,1072,210,2100,2025-07-26
FC_NJ05,SKU001350,520,160,360,84,840,2025-07-23
FC_NJ05,SKU001303,1571,454,1117,210,2100,2025-07-26
FC_NJ05,SKU000057,564,172,392,84,840,2025-07-22
FC_NJ05,SKU000381,824,216,608,140,1400,2025-07-23
FC_NJ05,SKU000118,816,247,569,140,1400,2025-07-22
FC_NJ05,SKU000034,606,171,435,112,1120,2025-07-27
FC_NJ05,SKU000796,269,81,188,56,560,2025-07-25
FC_NJ05,SKU001166,605,185,420,112,1120,2025-07-24
FC_NJ05,SKU001776,811,244,567,140,1400,2025-07-27
FC_NJ05,SKU000352,553,172,381,84,840,2025-07-21
FC_NJ05,SKU000046,828,256,572,140,1400,2025-07-23
FC_NJ05,SKU001286,563,182,381,84,840,2025-07-25
FC_NJ05,SKU000745,617,187,430,112,1120,2025-07-21
FC_NJ05,SKU001628,628,192,436,112,1120,2025-07-24
FC_NJ05,SKU000162,1596,462,1134,210,2100,2025-07-25
FC_NJ05,SKU000314,1643,511,1132,210,2100,2025-07-24
FC_NJ05,SKU001361,831,236,595,140,1400,2025-07-24
FC_NJ05,SKU000467,254,73,181,56,560,2025-07-21
FC_NJ05,SKU001574,238,73,165,56,560,2025-07-23
FC_NJ05,SKU001816,224,77,147,56,560,2025-07-21
FC_NJ05,SKU000343,1591,483,1108,210,2100,2025-07-25
FC_NJ05,SKU001295,1502,439,1063,210,2100,2025-07-25
FC_NJ05,SKU001022,1575,485,1090,210,2100,2025-07-25
FC_NJ05,SKU000338,578,199,379,112,1120,2025-07-21
FC_NJ05,SKU000556,586,178,408,112,1120,2025-07-24
FC_NJ05,SKU000429,1615,463,1152,210,2100,2025-07-27
FC_NJ05,SKU000325,628,185,443,112,1120,2025-07-24
FC_NJ05,SKU001690,551,152,399,84,840,2025-07-27
FC_NJ05,SKU000172,252,84,168,56,560,2025-07-24
FC_NJ05,SKU001861,1634,475,1159,210,2100,2025-07-21
FC_NJ05,SKU001723,808,226,582,140,1400,2025-07-24
FC_NJ05,SKU000205,1590,453,1137,210,2100,2025-07-27
FC_NJ05,SKU001592,623,174,449,112,1120,2025-07-23
FC_NJ05,SKU001921,253,78,175,56,560,2025-07-22
FC_NJ05,SKU000483,274,88,186,56,560,2025-07-27
FC_NJ05,SKU001118,540,158,382,84,840,2025-07-23
FC_NJ05,SKU000380,611,170,441,112,1120,2025-07-24
FC_NJ05,SKU000811,555,170,385,84,840,2025-07-25
FC_NJ05,SKU000038,1568,480,1088,210,2100,2025-07-21
FC_NJ05,SKU000055,245,66,179,56,560,2025-07-22
FC_NJ05,SKU000409,622,193,429,112,1120,2025-07-22
FC_NJ05,SKU000466,804,228,576,140,1400,2025-07-23
FC_NJ05,SKU000223,238,65,173,56,560,2025-07-25
FC_NJ05,SKU000853,1574,495,1079,210,2100,2025-07-21
FC_NJ05,SKU001147,591,176,415,112,1120,2025-07-21
FC_NJ05,SKU001888,824,271,553,140,1400,2025-07-26
FC_NJ05,SKU001624,1576,437,1139,210,2100,2025-07-24
FC_NJ05,SKU001795,889,288,601,140,1400,2025-07-27
FC_NJ05,SKU001134,1515,441,1074,210,2100,2025-07-25
FC_NJ05,SKU001872,265,81,184,56,560,2025-07-23
FC_NJ05,SKU000028,1568,495,1073,210,2100,2025-07-26
FC_NJ05,SKU000256,620,179,441,112,1120,2025-07-23
FC_NJ05,SKU001582,820,269,551,140,1400,2025-07-27
FC_NJ05,SKU001941,586,166,420,112,1120,2025-07-21
FC_NJ05,SKU000125,1605,461,1144,210,2100,2025-07-25
FC_NJ05,SKU000637,575,175,400,84,840,2025-07-27
FC_NJ05,SKU001617,554,139,415,84,840,2025-07-24
FC_NJ05,SKU001671,628,183,445,112,1120,2025-07-25
FC_NJ05,SKU001105,1503,396,1107,210,2100,2025-07-21
FC_NJ05,SKU000285,552,141,411,84,840,2025-07-26
FC_NJ05,SKU001880,563,173,390,84,840,2025-07-21
FC_NJ05,SKU001850,262,81,181,56,560,2025-07-24
FC_NJ05,SKU001930,572,165,407,84,840,2025-07-23
FC_NJ05,SKU001731,1564,483,1081,210,2100,2025-07-25
FC_NJ05,SKU000161,563,159,404,84,840,2025-07-22
FC_NJ05,SKU001894,539,148,391,84,840,2025-07-26
FC_NJ05,SKU000262,259,87,172,56,560,2025-07-25
FC_NJ05,SKU001475,257,71,186,56,560,2025-07-23
FC_NJ05,SKU000426,1514,473,1041,210,2100,2025-07-21
FC_NJ05,SKU001284,781,216,565,140,1400,2025-07-26
FC_NJ05,SKU001714,641,211,430,112,1120,2025-07-22
FC_NJ05,SKU001770,1636,491,1145,210,2100,2025-07-26
FC_NJ05,SKU000710,268,77,191,56,560,2025-07-21
FC_NJ05,SKU001845,570,151,419,84,840,2025-07-21
FC_NJ05,SKU000335,624,187,437,112,1120,2025-07-27
FC_NJ05,SKU000581,243,80,163,56,560,2025-07-24
FC_NJ05,SKU000960,534,147,387,84,840,2025-07-24
FC_NJ05,SKU001121,232,70,162,56,560,2025-07-25
FC_NJ05,SKU000554,629,186,443,112,1120,2025-07-23
FC_NJ05,SKU000297,601,169,432,112,1120,2025-07-21
FC_NJ05,SKU000090,1534,461,1073,210,2100,2025-07-24
FC_NJ05,SKU000315,626,181,445,112,1120,2025-07-26
FC_NJ05,SKU000214,585,176,409,112,1120,2025-07-25
FC_NJ05,SKU000917,552,174,378,84,840,2025-07-22
FC_NJ05,SKU000263,845,272,573,140,1400,2025-07-23
FC_NJ05,SKU000313,1551,430,1121,210,2100,2025-07-26
FC_NJ05,SKU000288,568,183,385,84,840,2025-07-25
FC_NJ05,SKU001553,546,165,381,84,840,2025-07-21
FC_NJ05,SKU001806,822,234,588,140,1400,2025-07-27
FC_NJ05,SKU001065,1551,470,1081,210,2100,2025-07-27
FC_NJ05,SKU001066,565,193,372,84,840,2025-07-26
FC_NJ05,SKU000393,236,74,162,56,560,2025-07-25
FC_NJ05,SKU000769,624,167,457,112,1120,2025-07-25
FC_NJ05,SKU000296,223,65,158,56,560,2025-07-27
FC_NJ05,SKU001053,554,162,392,84,840,2025-07-24
FC_NJ05,SKU001860,245,88,157,56,560,2025-07-23
FC_NJ05,SKU001997,543,145,398,84,840,2025-07-26
FC_NJ05,SKU001828,811,221,590,140,1400,2025-07-26
FC_NJ05,SKU000543,830,245,585,140,1400,2025-07-27
FC_NJ05,SKU000021,820,229,591,140,1400,2025-07-27
FC_NJ05,SKU000322,845,268,577,140,1400,2025-07-21
FC_NJ05,SKU001924,800,256,544,140,1400,2025-07-26
FC_NJ05,SKU001810,637,174,463,112,1120,2025-07-26
FC_NJ05,SKU000235,839,247,592,140,1400,2025-07-27
FC_NJ05,SKU000488,534,172,362,84,840,2025-07-21
FC_NJ05,SKU001602,837,262,575,140,1400,2025-07-25
FC_NJ05,SKU001043,257,76,181,56,560,2025-07-25
FC_NJ05,SKU001763,839,263,576,140,1400,2025-07-21
FC_NJ05,SKU000278,830,253,577,140,1400,2025-07-22
FC_NJ05,SKU000064,590,181,409,112,1120,2025-07-27
FC_NJ05,SKU000312,789,239,550,140,1400,2025-07-27
FC_NJ05,SKU000102,251,78,173,56,560,2025-07-27
FC_NJ05,SKU001822,1570,455,1115,210,2100,2025-07-27
FC_NJ05,SKU001245,623,193,430,112,1120,2025-07-26
FC_NJ05,SKU000698,1577,450,1127,210,2100,2025-07-24
FC_NJ05,SKU000662,265,79,186,56,560,2025-07-24
FC_NJ05,SKU001956,1564,468,1096,210,2100,2025-07-26
FC_NJ05,SKU001193,227,64,163,56,560,2025-07-23
FC_NJ05,SKU000240,227,82,145,56,560,2025-07-23
FC_NJ05,SKU001459,600,162,438,112,1120,2025-07-22
FC_NJ05,SKU000944,265,78,187,56,560,2025-07-26
FC_NJ05,SKU000318,549,160,389,84,840,2025-07-26
FC_NJ05,SKU001282,845,220,625,140,1400,2025-07-27
FC_NJ05,SKU000778,526,150,376,84,840,2025-07-24
FC_NJ05,SKU000537,645,206,439,112,1120,2025-07-24
FC_NJ05,SKU000828,617,186,431,112,1120,2025-07-24
FC_NJ05,SKU001294,607,184,423,112,1120,2025-07-26
FC_NJ05,SKU000719,630,191,439,112,1120,2025-07-24
FC_NJ05,SKU000184,525,154,371,84,840,2025-07-26
FC_NJ05,SKU000331,1567,520,1047,210,2100,2025-07-26
FC_NJ05,SKU001253,252,71,181,56,560,2025-07-21
FC_NJ05,SKU000275,566,168,398,112,1120,2025-07-25
FC_NJ05,SKU001427,542,156,386,84,840,2025-07-21
FC_NJ05,SKU000372,555,186,369,84,840,2025-07-27
FC_NJ05,SKU001196,816,250,566,140,1400,2025-07-25
FC_NJ05,SKU001267,844,243,601,140,1400,2025-07-25
FC_NJ05,SKU000889,622,178,444,112,1120,2025-07-27
FC_NJ05,SKU000911,250,76,174,56,560,2025-07-27
FC_NJ05,SKU001668,239,58,181,56,560,2025-07-23
FC_NJ05,SKU000580,592,193,399,112,1120,2025-07-24
FC_NJ05,SKU000153,619,197,422,112,1120,2025-07-27
FC_NJ05,SKU000785,602,180,422,84,840,2025-07-25
FC_NJ05,SKU000211,852,247,605,140,1400,2025-07-26
FC_NJ05,SKU000953,566,195,371,84,840,2025-07-24
FC_NJ05,SKU001210,802,262,540,140,1400,2025-07-23
FC_NJ05,SKU000185,800,266,534,140,1400,2025-07-23
FC_NJ05,SKU000136,235,76,159,56,560,2025-07-26
FC_NJ05,SKU000119,1611,483,1128,210,2100,2025-07-25
FC_NJ05,SKU000306,785,256,529,140,1400,2025-07-24
FC_NJ05,SKU000836,890,280,610,140,1400,2025-07-21
FC_NJ05,SKU000947,623,201,422,112,1120,2025-07-21
FC_NJ05,SKU000450,655,205,450,112,1120,2025-07-24
FC_NJ05,SKU001360,1555,496,1059,210,2100,2025-07-26
FC_NJ05,SKU000612,526,154,372,84,840,2025-07-25
FC_NJ05,SKU000872,889,251,638,140,1400,2025-07-22
FC_NJ05,SKU001597,842,272,570,140,1400,2025-07-26
FC_NJ05,SKU001250,555,167,388,84,840,2025-07-26
FC_NJ05,SKU001462,1603,481,1122,210,2100,2025-07-21
FC_NJ05,SKU000367,557,159,398,112,1120,2025-07-22
FC_NJ05,SKU000049,844,256,588,140,1400,2025-07-25
FC_NJ05,SKU000831,846,227,619,140,1400,2025-07-25
FC_NJ05,SKU001565,527,170,357,84,840,2025-07-22
FC_NJ05,SKU001484,577,196,381,84,840,2025-07-25
FC_NJ05,SKU000124,203,54,149,56,560,2025-07-25
FC_NJ05,SKU000451,227,68,159,56,560,2025-07-27
FC_NJ05,SKU001104,593,185,408,112,1120,2025-07-27
FC_NJ05,SKU001051,513,140,373,84,840,2025-07-21
FC_NJ05,SKU000609,617,180,437,112,1120,2025-07-27
FC_NJ05,SKU001519,572,153,419,84,840,2025-07-21
FC_NJ05,SKU001261,241,74,167,56,560,2025-07-25
FC_NJ05,SKU000749,275,75,200,56,560,2025-07-22
FC_NJ05,SKU001314,242,85,157,56,560,2025-07-26
FC_NJ05,SKU001099,1528,439,1089,210,2100,2025-07-22
FC_NJ05,SKU000800,580,168,412,84,840,2025-07-21
FC_NJ05,SKU001202,545,148,397,84,840,2025-07-21
FC_NJ05,SKU001000,1590,468,1122,210,2100,2025-07-27
FC_NJ05,SKU000457,843,265,578,140,1400,2025-07-24
FC_NJ05,SKU001162,627,188,439,112,1120,2025-07-24
FC_NJ05,SKU000512,522,162,360,84,840,2025-07-25
FC_NJ05,SKU000571,857,236,621,140,1400,2025-07-23
FC_NJ05,SKU000910,235,70,165,56,560,2025-07-22
FC_NJ05,SKU000528,821,244,577,140,1400,2025-07-26
FC_NJ05,SKU000772,251,72,179,56,560,2025-07-24
FC_NJ05,SKU000402,1534,433,1101,210,2100,2025-07-25
FC_NJ05,SKU000601,854,259,595,140,1400,2025-07-21
FC_NJ05,SKU000792,1578,464,1114,210,2100,2025-07-25
FC_NJ05,SKU001769,249,74,175,56,560,2025-07-25
FC_NJ05,SKU001794,614,196,418,112,1120,2025-07-24
FC_NJ05,SKU000097,246,79,167,56,560,2025-07-27
FC_NJ05,SKU001523,1523,396,1127,210,2100,2025-07-23
FC_NJ05,SKU001867,638,194,444,112,1120,2025-07-22
FC_NJ05,SKU000893,593,166,427,84,840,2025-07-23
FC_NJ05,SKU001760,1593,525,1068,210,2100,2025-07-26
FC_NJ05,SKU000082,611,168,443,112,1120,2025-07-25
FC_NJ05,SKU000691,571,181,390,84,840,2025-07-24
FC_NJ05,SKU001742,506,139,367,84,840,2025-07-27
FC_NJ05,SKU000726,260,90,170,56,560,2025-07-23
FC_NJ05,SKU000386,529,163,366,84,840,2025-07-27
FC_NJ05,SKU001031,221,89,132,56,560,2025-07-27
FC_NJ05,SKU000672,606,158,448,112,1120,2025-07-23
FC_NJ05,SKU000294,852,275,577,140,1400,2025-07-23
FC_NJ05,SKU001869,546,154,392,84,840,2025-07-23
FC_NJ05,SKU001276,639,186,453,112,1120,2025-07-22
FC_NJ05,SKU001518,822,252,570,140,1400,2025-07-24
FC_NJ05,SKU000570,1552,444,1108,210,2100,2025-07-24
FC_NJ05,SKU000449,281,101,180,56,560,2025-07-22
FC_NJ05,SKU000891,566,170,396,84,840,2025-07-25
FC_NJ05,SKU000289,541,155,386,84,840,2025-07-24
FC_NJ05,SKU001673,513,138,375,84,840,2025-07-27
FC_NJ05,SKU000062,224,80,144,56,560,2025-07-24
FC_NJ05,SKU001451,1545,478,1067,210,2100,2025-07-22
FC_NJ05,SKU001916,591,194,397,112,1120,2025-07-27
FC_NJ05,SKU000440,821,282,539,140,1400,2025-07-23
FC_NJ05,SKU001917,1537,481,1056,210,2100,2025-07-21
FC_NJ05,SKU001526,851,252,599,140,1400,2025-07-25
FC_NJ05,SKU001299,617,164,453,112,1120,2025-07-26
FC_NJ05,SKU001643,555,192,363,84,840,2025-07-26
FC_NJ05,SKU000043,1589,467,1122,210,2100,2025-07-24
FC_NJ05,SKU001092,1592,511,1081,210,2100,2025-07-23
FC_NJ05,SKU000500,246,73,173,56,560,2025-07-24
FC_NJ05,SKU001025,245,77,168,56,560,2025-07-27
FC_NJ05,SKU000461,634,181,453,112,1120,2025-07-26
FC_NJ05,SKU001733,641,219,422,112,1120,2025-07-22
FC_NJ05,SKU000104,604,195,409,112,1120,2025-07-21
FC_NJ05,SKU001214,1591,499,1092,210,2100,2025-07-27
FC_NJ05,SKU001197,250,81,169,56,560,2025-07-21
FC_NJ05,SKU001864,510,154,356,84,840,2025-07-21
FC_NJ05,SKU000077,1491,448,1043,210,2100,2025-07-22
FC_NJ05,SKU000995,1577,500,1077,210,2100,2025-07-27
FC_NJ05,SKU001885,602,189,413,112,1120,2025-07-22
FC_NJ05,SKU000548,213,69,144,56,560,2025-07-21
FC_NJ05,SKU000066,256,70,186,56,560,2025-07-21
FC_NJ05,SKU001966,596,187,409,112,1120,2025-07-21
FC_NJ05,SKU000015,1550,475,1075,210,2100,2025-07-23
FC_NJ05,SKU000975,839,250,589,140,1400,2025-07-23
FC_NJ05,SKU001697,842,238,604,140,1400,2025-07-26
FC_NJ05,SKU000276,586,210,376,84,840,2025-07-25
FC_NJ05,SKU001970,873,241,632,140,1400,2025-07-25
FC_NJ05,SKU001046,606,197,409,112,1120,2025-07-22
FC_NJ05,SKU001875,608,184,424,112,1120,2025-07-26
FC_NJ05,SKU000519,270,87,183,56,560,2025-07-27
FC_NJ05,SKU000459,836,226,610,140,1400,2025-07-21
FC_NJ05,SKU001371,546,163,383,84,840,2025-07-27
FC_NJ05,SKU001355,245,63,182,56,560,2025-07-27
FC_NJ05,SKU001911,546,157,389,84,840,2025-07-25
FC_NJ05,SKU000058,628,207,421,112,1120,2025-07-24
FC_NJ05,SKU000523,605,165,440,112,1120,2025-07-24
FC_NJ05,SKU000032,503,158,345,84,840,2025-07-21
FC_NJ05,SKU001524,1556,463,1093,210,2100,2025-07-25
FC_NJ05,SKU001479,604,173,431,112,1120,2025-07-22
FC_NJ05,SKU001531,563,159,404,84,840,2025-07-26
FC_NJ05,SKU000759,564,173,391,84,840,2025-07-26
FC_NJ05,SKU000626,668,200,468,112,1120,2025-07-26
FC_NJ05,SKU000787,239,58,181,56,560,2025-07-25
FC_NJ05,SKU000727,1572,469,1103,210,2100,2025-07-21
FC_NJ05,SKU000643,854,259,595,140,1400,2025-07-22
FC_NJ05,SKU001420,521,148,373,84,840,2025-07-24
FC_NJ05,SKU000505,557,168,389,84,840,2025-07-22
FC_NJ05,SKU001939,536,157,379,84,840,2025-07-25
FC_NJ05,SKU000871,556,149,407,112,1120,2025-07-21
FC_NJ05,SKU001737,905,274,631,140,1400,2025-07-22
FC_NJ05,SKU001381,633,180,453,112,1120,2025-07-22
FC_NJ05,SKU000847,260,64,196,56,560,2025-07-22
FC_NJ05,SKU001027,1604,460,1144,210,2100,2025-07-27
FC_NJ05,SKU001546,239,74,165,56,560,2025-07-22
FC_NJ05,SKU001144,545,166,379,84,840,2025-07-25
FC_NJ05,SKU001136,541,187,354,84,840,2025-07-23
FC_NJ05,SKU001560,1570,490,1080,210,2100,2025-07-25
FC_NJ05,SKU001001,1560,473,1087,210,2100,2025-07-23
FC_NJ05,SKU000173,1600,502,1098,210,2100,2025-07-26
FC_NJ05,SKU000403,222,55,167,56,560,2025-07-24
FC_NJ05,SKU000723,597,189,408,112,1120,2025-07-22
FC_NJ05,SKU001452,278,88,190,56,560,2025-07-26
FC_NJ05,SKU001226,247,80,167,56,560,2025-07-21
FC_NJ05,SKU001773,276,84,192,56,560,2025-07-26
FC_NJ05,SKU001184,620,167,453,112,1120,2025-07-25
FC_NJ05,SKU001447,884,271,613,140,1400,2025-07-25
FC_NJ05,SKU000518,620,183,437,112,1120,2025-07-22
FC_NJ05,SKU001229,263,74,189,56,560,2025-07-25
FC_NJ05,SKU000862,544,142,402,84,840,2025-07-23
FC_NJ05,SKU000327,851,236,615,140,1400,2025-07-24
FC_NJ05,SKU000487,269,85,184,56,560,2025-07-22
FC_NJ05,SKU001326,266,56,210,56,560,2025-07-23
FC_NJ05,SKU001464,1537,480,1057,210,2100,2025-07-23
FC_NJ05,SKU001843,574,161,413,112,1120,2025-07-27
FC_NJ05,SKU000370,846,239,607,140,1400,2025-07-21
FC_NJ05,SKU001719,641,174,467,112,1120,2025-07-22
FC_NJ05,SKU001093,270,104,166,56,560,2025-07-21
FC_NJ05,SKU000628,293,88,205,56,560,2025-07-26
FC_NJ05,SKU001403,234,58,176,56,560,2025-07-21
FC_NJ05,SKU000164,627,191,436,112,1120,2025-07-22
FC_NJ05,SKU001618,835,258,577,140,1400,2025-07-26
FC_NJ05,SKU000140,253,67,186,56,560,2025-07-26
FC_NJ05,SKU001598,254,60,194,56,560,2025-07-24
FC_NJ05,SKU001883,1600,476,1124,210,2100,2025-07-24
FC_NJ05,SKU001020,272,72,200,56,560,2025-07-25
FC_NJ05,SKU000541,588,169,419,84,840,2025-07-21
FC_NJ05,SKU001844,664,191,473,112,1120,2025-07-27
FC_NJ05,SKU001390,549,175,374,84,840,2025-07-23
FC_NJ05,SKU000776,824,264,560,140,1400,2025-07-24
FC_NJ05,SKU001320,843,250,593,140,1400,2025-07-27
FC_NJ05,SKU000373,274,81,193,56,560,2025-07-25
FC_NJ05,SKU001991,692,215,477,112,1120,2025-07-24
FC_NJ05,SKU000606,851,277,574,140,1400,2025-07-27
FC_NJ05,SKU000654,270,78,192,56,560,2025-07-22
FC_NJ05,SKU000794,869,268,601,140,1400,2025-07-26
FC_NJ05,SKU000535,255,61,194,56,560,2025-07-24
FC_NJ05,SKU001384,1556,463,1093,210,2100,2025-07-21
FC_NJ05,SKU000706,238,68,170,56,560,2025-07-26
FC_NJ05,SKU001157,1550,464,1086,210,2100,2025-07-27
FC_NJ05,SKU000374,603,190,413,112,1120,2025-07-23
FC_NJ05,SKU000167,614,188,426,112,1120,2025-07-22
FC_NJ05,SKU001421,606,193,413,112,1120,2025-07-22
FC_NJ05,SKU000694,251,73,178,56,560,2025-07-23
FC_NJ05,SKU000072,636,217,419,112,1120,2025-07-23
FC_NJ05,SKU001251,238,76,162,56,560,2025-07-22
FC_NJ05,SKU000490,597,163,434,112,1120,2025-07-24
FC_NJ05,SKU000617,266,74,192,56,560,2025-07-23
FC_NJ05,SKU001119,1572,462,1110,210,2100,2025-07-24
FC_NJ05,SKU001347,1539,452,1087,210,2100,2025-07-27
FC_NJ05,SKU000587,812,251,561,140,1400,2025-07-25
FC_NJ05,SKU001132,595,157,438,112,1120,2025-07-23
FC_NJ05,SKU000976,619,171,448,112,1120,2025-07-22
FC_NJ05,SKU000905,540,154,386,84,840,2025-07-26
FC_NJ05,SKU000404,640,185,455,112,1120,2025-07-24
FC_NJ05,SKU001681,791,242,549,140,1400,2025-07-21
FC_NJ05,SKU000433,265,86,179,56,560,2025-07-21
FC_NJ05,SKU000938,262,95,167,56,560,2025-07-23
FC_NJ05,SKU001480,627,186,441,112,1120,2025-07-26
FC_NJ05,SKU000553,817,240,577,140,1400,2025-07-25
FC_NJ05,SKU000718,605,193,412,84,840,2025-07-22
FC_NJ05,SKU001640,595,176,419,112,1120,2025-07-24
FC_NJ05,SKU001026,1552,420,1132,210,2100,2025-07-22
FC_NJ05,SKU001083,1559,447,1112,210,2100,2025-07-25
FC_NJ05,SKU001985,569,171,398,84,840,2025-07-24
FC_NJ05,SKU001155,540,145,395,84,840,2025-07-27
FC_NJ05,SKU000496,504,165,339,84,840,2025-07-25
FC_NJ05,SKU001739,653,188,465,112,1120,2025-07-25
FC_NJ05,SKU001223,624,191,433,112,1120,2025-07-27
FC_NJ05,SKU000241,1507,464,1043,210,2100,2025-07-27
FC_NJ05,SKU001496,237,73,164,56,560,2025-07-23
FC_NJ05,SKU000579,644,207,437,112,1120,2025-07-23
FC_NJ05,SKU001019,1607,457,1150,210,2100,2025-07-26
FC_NJ05,SKU001664,247,68,179,56,560,2025-07-23
FC_NJ05,SKU000198,1610,495,1115,210,2100,2025-07-22
FC_NJ05,SKU000074,1527,457,1070,210,2100,2025-07-26
FC_NJ05,SKU000145,1592,452,1140,210,2100,2025-07-27
FC_NJ05,SKU001724,1608,446,1162,210,2100,2025-07-25
FC_NJ05,SKU000669,246,75,171,56,560,2025-07-21
FC_NJ05,SKU000024,616,212,404,112,1120,2025-07-22
FC_NJ05,SKU000703,524,156,368,84,840,2025-07-27
FC_NJ05,SKU001738,1565,473,1092,210,2100,2025-07-24
FC_NJ05,SKU001963,512,170,342,84,840,2025-07-26
FC_NJ05,SKU001511,247,88,159,56,560,2025-07-23
FC_NJ05,SKU000503,248,79,169,56,560,2025-07-25
FC_NJ05,SKU000750,646,207,439,112,1120,2025-07-25
FC_NJ05,SKU001537,833,269,564,140,1400,2025-07-25
FC_NJ05,SKU001495,271,78,193,56,560,2025-07-21
FC_NJ05,SKU001953,1568,472,1096,210,2100,2025-07-21
FC_NJ05,SKU001010,228,62,166,56,560,2025-07-22
FC_NJ05,SKU000849,1591,464,1127,210,2100,2025-07-21
FC_NJ05,SKU000031,264,87,177,56,560,2025-07-27
FC_NJ05,SKU000291,1530,471,1059,210,2100,2025-07-21
FC_NJ05,SKU000452,854,257,597,140,1400,2025-07-24
FC_NJ05,SKU001204,268,108,160,56,560,2025-07-25
FC_NJ05,SKU000598,590,169,421,84,840,2025-07-22
FC_NJ05,SKU000394,257,60,197,56,560,2025-07-24
FC_NJ05,SKU001972,260,78,182,56,560,2025-07-23
FC_NJ05,SKU000692,596,198,398,112,1120,2025-07-25
FC_NJ05,SKU000181,838,234,604,140,1400,2025-07-27
FC_NJ05,SKU000957,614,199,415,112,1120,2025-07-25
FC_NJ05,SKU000675,1511,461,1050,210,2100,2025-07-23
FC_NJ05,SKU000782,859,242,617,140,1400,2025-07-21
FC_NJ05,SKU000400,1561,441,1120,210,2100,2025-07-22
FC_NJ05,SKU000599,259,66,193,56,560,2025-07-27
FC_NJ05,SKU000748,613,187,426,112,1120,2025-07-25
FC_NJ05,SKU000763,872,248,624,140,1400,2025-07-25
FC_NJ05,SKU001622,593,181,412,112,1120,2025-07-24
FC_NJ05,SKU000700,267,67,200,56,560,2025-07-27
FC_NJ05,SKU000949,852,267,585,140,1400,2025-07-26
FC_NJ05,SKU000493,218,72,146,56,560,2025-07-21
FC_NJ05,SKU000408,613,182,431,112,1120,2025-07-25
FC_NJ05,SKU001301,643,187,456,112,1120,2025-07-24
FC_NJ05,SKU000272,885,288,597,140,1400,2025-07-24
FC_NJ05,SKU000379,588,144,444,112,1120,2025-07-25
FC_NJ05,SKU000345,1565,451,1114,210,2100,2025-07-27
FC_NJ05,SKU001406,624,207,417,112,1120,2025-07-22
FC_NJ05,SKU001965,1626,500,1126,210,2100,2025-07-24
FC_NJ05,SKU000861,551,165,386,84,840,2025-07-24
FC_NJ05,SKU001958,619,196,423,112,1120,2025-07-22
FC_NJ05,SKU001244,1544,497,1047,210,2100,2025-07-21
FC_NJ05,SKU000133,532,142,390,84,840,2025-07-21
FC_NJ05,SKU000303,246,80,166,56,560,2025-07-22
FC_NJ05,SKU001709,260,86,174,56,560,2025-07-21
FC_NJ05,SKU001998,845,240,605,140,1400,2025-07-23
FC_NJ05,SKU000359,834,248,586,140,1400,2025-07-27
FC_NJ05,SKU000093,894,238,656,140,1400,2025-07-27
FC_NJ05,SKU000344,821,219,602,140,1400,2025-07-26
FC_NJ05,SKU000151,251,73,178,56,560,2025-07-21
FC_NJ05,SKU001746,881,275,606,140,1400,2025-07-26
FC_NJ05,SKU001693,594,185,409,112,1120,2025-07-21
FC_NJ05,SKU000376,1578,481,1097,210,2100,2025-07-23
FC_NJ05,SKU001116,569,186,383,84,840,2025-07-26
FC_NJ05,SKU000144,651,191,460,112,1120,2025-07-21
FC_NJ05,SKU000305,235,70,165,56,560,2025-07-24
FC_NJ05,SKU000725,638,176,462,112,1120,2025-07-22
FC_NJ05,SKU000932,531,170,361,84,840,2025-07-21
FC_NJ05,SKU001075,640,196,444,112,1120,2025-07-22
FC_NJ05,SKU000018,1531,436,1095,210,2100,2025-07-22
FC_NJ05,SKU000961,259,86,173,56,560,2025-07-21
FC_NJ05,SKU000183,584,168,416,112,1120,2025-07-21
FC_NJ05,SKU001626,1571,456,1115,210,2100,2025-07-24
FC_NJ05,SKU001559,1514,466,1048,210,2100,2025-07-25
FC_NJ05,SKU001812,846,236,610,140,1400,2025-07-27
FC_NJ05,SKU000437,1538,431,1107,210,2100,2025-07-26
FC_IL06,SKU001126,566,191,375,84,840,2025-07-26
FC_IL06,SKU000637,551,149,402,84,840,2025-07-25
FC_IL06,SKU001381,594,174,420,112,1120,2025-07-22
FC_IL06,SKU001578,598,173,425,112,1120,2025-07-21
FC_IL06,SKU001835,514,145,369,84,840,2025-07-21
FC_IL06,SKU001527,235,71,164,56,560,2025-07-21
FC_IL06,SKU000309,555,189,366,84,840,2025-07-27
FC_IL06,SKU000775,539,174,365,84,840,2025-07-24
FC_IL06,SKU000175,594,182,412,112,1120,2025-07-27
FC_IL06,SKU000776,853,246,607,140,1400,2025-07-26
FC_IL06,SKU000660,627,213,414,112,1120,2025-07-24
FC_IL06,SKU000786,621,205,416,112,1120,2025-07-24
FC_IL06,SKU001991,599,165,434,112,1120,2025-07-23
FC_IL06,SKU000298,660,182,478,112,1120,2025-07-25
FC_IL06,SKU001239,566,189,377,84,840,2025-07-25
FC_IL06,SKU001480,606,185,421,112,1120,2025-07-26
FC_IL06,SKU001814,858,243,615,140,1400,2025-07-27
FC_IL06,SKU001642,773,218,555,140,1400,2025-07-25
FC_IL06,SKU001682,837,264,573,140,1400,2025-07-22
FC_IL06,SKU000345,1571,440,1131,210,2100,2025-07-23
FC_IL06,SKU001645,817,232,585,140,1400,2025-07-23
FC_IL06,SKU000921,563,157,406,84,840,2025-07-21
FC_IL06,SKU000630,1589,470,1119,210,2100,2025-07-24
FC_IL06,SKU000831,868,276,592,140,1400,2025-07-24
FC_IL06,SKU001787,856,231,625,140,1400,2025-07-24
FC_IL06,SKU000473,881,267,614,140,1400,2025-07-22
FC_IL06,SKU000414,516,165,351,84,840,2025-07-26
FC_IL06,SKU001279,224,77,147,56,560,2025-07-22
FC_IL06,SKU001926,651,193,458,112,1120,2025-07-21
FC_IL06,SKU001217,1560,473,1087,210,2100,2025-07-25
FC_IL06,SKU001767,226,74,152,56,560,2025-07-25
FC_IL06,SKU001352,824,231,593,140,1400,2025-07-27
FC_IL06,SKU000010,246,68,178,56,560,2025-07-23
FC_IL06,SKU000609,633,205,428,112,1120,2025-07-22
FC_IL06,SKU000732,819,248,571,140,1400,2025-07-23
FC_IL06,SKU001781,252,71,181,56,560,2025-07-25
FC_IL06,SKU001289,572,168,404,112,1120,2025-07-27
FC_IL06,SKU001768,240,82,158,56,560,2025-07-21
FC_IL06,SKU001919,835,270,565,140,1400,2025-07-26
FC_IL06,SKU000963,835,238,597,140,1400,2025-07-21
FC_IL06,SKU001347,1473,445,1028,210,2100,2025-07-25
FC_IL06,SKU000496,593,171,422,84,840,2025-07-24
FC_IL06,SKU001269,1577,453,1124,210,2100,2025-07-27
FC_IL06,SKU001438,806,254,552,140,1400,2025-07-26
FC_IL06,SKU000734,572,180,392,84,840,2025-07-22
FC_IL06,SKU001213,1529,443,1086,210,2100,2025-07-23
FC_IL06,SKU001276,619,179,440,112,1120,2025-07-25
FC_IL06,SKU000584,634,200,434,112,1120,2025-07-27
FC_IL06,SKU001455,595,188,407,112,1120,2025-07-23
FC_IL06,SKU000389,640,196,444,112,1120,2025-07-27
FC_IL06,SKU001246,1500,434,1066,210,2100,2025-07-27
FC_IL06,SKU000118,816,242,574,140,1400,2025-07-25
FC_IL06,SKU001980,832,247,585,140,1400,2025-07-22
FC_IL06,SKU001796,569,185,384,112,1120,2025-07-26
FC_IL06,SKU001861,1564,475,1089,210,2100,2025-07-25
FC_IL06,SKU000357,1606,501,1105,210,2100,2025-07-22
FC_IL06,SKU000497,1557,519,1038,210,2100,2025-07-21
FC_IL06,SKU001442,855,261,594,140,1400,2025-07-24
FC_IL06,SKU000665,552,170,382,84,840,2025-07-26
FC_IL06,SKU000664,867,257,610,140,1400,2025-07-26
FC_IL06,SKU000158,556,166,390,84,840,2025-07-21
FC_IL06,SKU001432,800,223,577,140,1400,2025-07-21
FC_IL06,SKU000903,1557,452,1105,210,2100,2025-07-24
FC_IL06,SKU001309,272,69,203,56,560,2025-07-27
FC_IL06,SKU001712,612,153,459,112,1120,2025-07-23
FC_IL06,SKU000356,554,159,395,84,840,2025-07-21
FC_IL06,SKU001266,599,164,435,112,1120,2025-07-26
FC_IL06,SKU000261,602,156,446,112,1120,2025-07-25
FC_IL06,SKU001071,248,62,186,56,560,2025-07-22
FC_IL06,SKU000590,624,189,435,112,1120,2025-07-26
FC_IL06,SKU001395,593,170,423,112,1120,2025-07-24
FC_IL06,SKU000626,645,184,461,112,1120,2025-07-23
FC_IL06,SKU001125,639,183,456,112,1120,2025-07-25
FC_IL06,SKU000510,1582,456,1126,210,2100,2025-07-25
FC_IL06,SKU001849,224,72,152,56,560,2025-07-23
FC_IL06,SKU001215,604,188,416,112,1120,2025-07-27
FC_IL06,SKU001307,883,273,610,140,1400,2025-07-22
FC_IL06,SKU000548,280,63,217,56,560,2025-07-26
FC_IL06,SKU000131,269,96,173,56,560,2025-07-24
FC_IL06,SKU001142,1573,477,1096,210,2100,2025-07-23
FC_IL06,SKU001334,258,78,180,56,560,2025-07-27
FC_IL06,SKU001510,266,68,198,56,560,2025-07-23
FC_IL06,SKU001544,638,174,464,112,1120,2025-07-22
FC_IL06,SKU001599,614,178,436,112,1120,2025-07-25
FC_IL06,SKU000346,247,77,170,56,560,2025-07-22
FC_IL06,SKU000772,239,61,178,56,560,2025-07-22
FC_IL06,SKU000030,609,172,437,112,1120,2025-07-25
FC_IL06,SKU001226,244,85,159,56,560,2025-07-21
FC_IL06,SKU001555,851,257,594,140,1400,2025-07-26
FC_IL06,SKU001248,617,176,441,112,1120,2025-07-23
FC_IL06,SKU000428,627,177,450,112,1120,2025-07-24
FC_IL06,SKU001601,563,154,409,84,840,2025-07-27
FC_IL06,SKU001491,253,85,168,56,560,2025-07-23
FC_IL06,SKU000990,253,79,174,56,560,2025-07-26
FC_IL06,SKU000869,495,142,353,84,840,2025-07-23
FC_IL06,SKU001909,1579,463,1116,210,2100,2025-07-22
FC_IL06,SKU001947,583,191,392,84,840,2025-07-23
FC_IL06,SKU001722,256,86,170,56,560,2025-07-21
FC_IL06,SKU001195,491,146,345,84,840,2025-07-21
FC_IL06,SKU001313,1505,434,1071,210,2100,2025-07-24
FC_IL06,SKU000129,636,180,456,112,1120,2025-07-25
FC_IL06,SKU000383,1553,462,1091,210,2100,2025-07-24
FC_IL06,SKU000691,567,155,412,84,840,2025-07-26
FC_IL06,SKU000839,238,68,170,56,560,2025-07-26
FC_IL06,SKU000516,646,181,465,112,1120,2025-07-25
FC_IL06,SKU000828,633,189,444,112,1120,2025-07-21
FC_IL06,SKU000465,853,238,615,140,1400,2025-07-24
FC_IL06,SKU001903,243,62,181,56,560,2025-07-27
FC_IL06,SKU000729,835,249,586,140,1400,2025-07-21
FC_IL06,SKU001539,603,193,410,112,1120,2025-07-24
FC_IL06,SKU001558,773,222,551,140,1400,2025-07-24
FC_IL06,SKU000689,249,70,179,56,560,2025-07-22
FC_IL06,SKU001551,816,243,573,140,1400,2025-07-27
FC_IL06,SKU001663,566,161,405,84,840,2025-07-24
FC_IL06,SKU000066,232,62,170,56,560,2025-07-23
FC_IL06,SKU000821,555,154,401,84,840,2025-07-21
FC_IL06,SKU000279,1532,463,1069,210,2100,2025-07-23
FC_IL06,SKU000335,666,216,450,112,1120,2025-07-27
FC_IL06,SKU001693,644,214,430,112,1120,2025-07-22
FC_IL06,SKU000919,910,281,629,140,1400,2025-07-21
FC_IL06,SKU001296,604,167,437,112,1120,2025-07-22
FC_IL06,SKU001135,824,249,575,140,1400,2025-07-21
FC_IL06,SKU000467,230,67,163,56,560,2025-07-24
FC_IL06,SKU000885,540,170,370,84,840,2025-07-24
FC_IL06,SKU001845,524,159,365,84,840,2025-07-23
FC_IL06,SKU001815,802,229,573,140,1400,2025-07-23
FC_IL06,SKU001407,856,253,603,140,1400,2025-07-21
FC_IL06,SKU001193,240,70,170,56,560,2025-07-25
FC_IL06,SKU001288,536,154,382,84,840,2025-07-21
FC_IL06,SKU001182,864,231,633,140,1400,2025-07-27
FC_IL06,SKU001918,842,282,560,140,1400,2025-07-21
FC_IL06,SKU001624,1536,417,1119,210,2100,2025-07-23
FC_IL06,SKU000619,1532,453,1079,210,2100,2025-07-24
FC_IL06,SKU001443,854,279,575,140,1400,2025-07-21
FC_IL06,SKU001489,254,92,162,56,560,2025-07-25
FC_IL06,SKU001590,251,76,175,56,560,2025-07-21
FC_IL06,SKU000111,261,76,185,56,560,2025-07-21
FC_IL06,SKU001218,812,241,571,140,1400,2025-07-27
FC_IL06,SKU001211,647,228,419,112,1120,2025-07-26
FC_IL06,SKU000781,1539,437,1102,210,2100,2025-07-25
FC_IL06,SKU001795,855,251,604,140,1400,2025-07-27
FC_IL06,SKU000454,549,162,387,84,840,2025-07-24
FC_IL06,SKU001605,814,218,596,140,1400,2025-07-27
FC_IL06,SKU001635,550,150,400,84,840,2025-07-25
FC_IL06,SKU000055,251,71,180,56,560,2025-07-25
FC_IL06,SKU000073,596,190,406,112,1120,2025-07-24
FC_IL06,SKU001457,1537,439,1098,210,2100,2025-07-27
FC_IL06,SKU001775,564,174,390,112,1120,2025-07-24
FC_IL06,SKU001271,838,266,572,140,1400,2025-07-22
FC_IL06,SKU001354,516,149,367,84,840,2025-07-22
FC_IL06,SKU001608,607,192,415,112,1120,2025-07-25
FC_IL06,SKU001328,556,169,387,112,1120,2025-07-23
FC_IL06,SKU000190,1581,491,1090,210,2100,2025-07-26
FC_IL06,SKU001344,1654,470,1184,210,2100,2025-07-26
FC_IL06,SKU000144,599,189,410,112,1120,2025-07-25
FC_IL06,SKU000751,617,161,456,112,1120,2025-07-27
FC_IL06,SKU000521,577,151,426,112,1120,2025-07-25
FC_IL06,SKU000754,262,76,186,56,560,2025-07-26
FC_IL06,SKU000641,628,190,438,112,1120,2025-07-25
FC_IL06,SKU000998,777,235,542,140,1400,2025-07-25
FC_IL06,SKU000427,795,248,547,140,1400,2025-07-26
FC_IL06,SKU001711,557,190,367,84,840,2025-07-24
FC_IL06,SKU000269,243,72,171,56,560,2025-07-24
FC_IL06,SKU001359,557,154,403,84,840,2025-07-22
FC_IL06,SKU000239,1531,481,1050,210,2100,2025-07-23
FC_IL06,SKU000324,1606,477,1129,210,2100,2025-07-26
FC_IL06,SKU000435,1598,495,1103,210,2100,2025-07-26
FC_IL06,SKU001572,833,237,596,140,1400,2025-07-25
FC_IL06,SKU000571,853,249,604,140,1400,2025-07-21
FC_IL06,SKU001627,859,274,585,140,1400,2025-07-22
FC_IL06,SKU001044,570,175,395,84,840,2025-07-23
FC_IL06,SKU001800,809,246,563,140,1400,2025-07-22
FC_IL06,SKU001423,818,217,601,140,1400,2025-07-25
FC_IL06,SKU001803,1644,492,1152,210,2100,2025-07-22
FC_IL06,SKU000958,648,193,455,112,1120,2025-07-25
FC_IL06,SKU001114,561,173,388,112,1120,2025-07-26
FC_IL06,SKU001067,1570,436,1134,210,2100,2025-07-24
FC_IL06,SKU000410,564,165,399,84,840,2025-07-24
FC_IL06,SKU000952,491,154,337,84,840,2025-07-22
FC_IL06,SKU000032,496,140,356,84,840,2025-07-23
FC_IL06,SKU000065,562,189,373,84,840,2025-07-23
FC_IL06,SKU000674,269,78,191,56,560,2025-07-22
FC_IL06,SKU001097,281,77,204,56,560,2025-07-26
FC_IL06,SKU001679,1522,430,1092,210,2100,2025-07-25
FC_IL06,SKU001698,824,268,556,140,1400,2025-07-21
FC_IL06,SKU001502,548,167,381,84,840,2025-07-25
FC_IL06,SKU001062,260,92,168,56,560,2025-07-23
FC_IL06,SKU000234,552,175,377,84,840,2025-07-23
FC_IL06,SKU001873,234,63,171,56,560,2025-07-27
FC_IL06,SKU001860,248,63,185,56,560,2025-07-22
FC_IL06,SKU000280,530,137,393,84,840,2025-07-24
FC_IL06,SKU001286,544,192,352,84,840,2025-07-27
FC_IL06,SKU000960,527,164,363,84,840,2025-07-26
FC_IL06,SKU001146,233,76,157,56,560,2025-07-21
FC_IL06,SKU000381,810,245,565,140,1400,2025-07-24
FC_IL06,SKU000577,885,265,620,140,1400,2025-07-23
FC_IL06,SKU000862,524,142,382,84,840,2025-07-21
FC_IL06,SKU000443,1542,455,1087,210,2100,2025-07-23
FC_IL06,SKU001247,849,287,562,140,1400,2025-07-24
FC_IL06,SKU000746,805,249,556,140,1400,2025-07-26
FC_IL06,SKU001398,525,168,357,84,840,2025-07-27
FC_IL06,SKU001573,606,188,418,112,1120,2025-07-26
FC_IL06,SKU000613,236,77,159,56,560,2025-07-23
FC_IL06,SKU001325,611,189,422,112,1120,2025-07-22
FC_IL06,SKU001998,827,253,574,140,1400,2025-07-23
FC_IL06,SKU001115,796,231,565,140,1400,2025-07-24
FC_IL06,SKU000254,814,223,591,140,1400,2025-07-21
FC_IL06,SKU001072,1513,436,1077,210,2100,2025-07-24
FC_IL06,SKU001561,1630,483,1147,210,2100,2025-07-23
FC_IL06,SKU000651,848,254,594,140,1400,2025-07-27
FC_IL06,SKU001197,250,79,171,56,560,2025-07-25
FC_IL06,SKU000390,1530,479,1051,210,2100,2025-07-23
FC_IL06,SKU001214,1546,478,1068,210,2100,2025-07-25
FC_IL06,SKU001203,585,175,410,112,1120,2025-07-22
FC_IL06,SKU001472,822,266,556,140,1400,2025-07-23
FC_IL06,SKU000166,599,191,408,112,1120,2025-07-21
FC_IL06,SKU000711,641,173,468,112,1120,2025-07-26
FC_IL06,SKU000980,233,72,161,56,560,2025-07-25
FC_IL06,SKU001893,838,248,590,140,1400,2025-07-25
FC_IL06,SKU001553,532,136,396,84,840,2025-07-23
FC_IL06,SKU001982,881,255,626,140,1400,2025-07-23
FC_IL06,SKU001755,1594,505,1089,210,2100,2025-07-26
FC_IL06,SKU001665,554,148,406,84,840,2025-07-23
FC_IL06,SKU000692,594,180,414,112,1120,2025-07-24
FC_IL06,SKU001834,281,81,200,56,560,2025-07-26
FC_IL06,SKU000394,253,71,182,56,560,2025-07-26
FC_IL06,SKU000303,259,82,177,56,560,2025-07-26
FC_IL06,SKU000953,497,131,366,84,840,2025-07-23
FC_IL06,SKU000778,528,159,369,84,840,2025-07-21
FC_IL06,SKU000562,869,257,612,140,1400,2025-07-26
FC_IL06,SKU000483,241,65,176,56,560,2025-07-24
FC_IL06,SKU000225,872,295,577,140,1400,2025-07-27
FC_IL06,SKU001250,529,157,372,84,840,2025-07-25
FC_IL06,SKU000163,1625,465,1160,210,2100,2025-07-27
FC_IL06,SKU001780,559,170,389,84,840,2025-07-22
FC_IL06,SKU001607,264,80,184,56,560,2025-07-26
FC_IL06,SKU000290,554,186,368,84,840,2025-07-26
FC_IL06,SKU000426,1549,501,1048,210,2100,2025-07-25
FC_IL06,SKU000341,638,172,466,112,1120,2025-07-24
FC_IL06,SKU000906,263,82,181,56,560,2025-07-25
FC_IL06,SKU000480,1513,477,1036,210,2100,2025-07-21
FC_IL06,SKU000216,1493,425,1068,210,2100,2025-07-25
FC_IL06,SKU001453,556,162,394,84,840,2025-07-27
FC_IL06,SKU001771,575,175,400,84,840,2025-07-27
FC_IL06,SKU001284,817,257,560,140,1400,2025-07-26
FC_IL06,SKU000997,237,75,162,56,560,2025-07-23
FC_IL06,SKU000572,845,241,604,140,1400,2025-07-21
FC_IL06,SKU000478,611,180,431,112,1120,2025-07-23
FC_IL06,SKU000575,852,232,620,140,1400,2025-07-26
FC_IL06,SKU000701,1623,488,1135,210,2100,2025-07-27
FC_IL06,SKU000967,883,262,621,140,1400,2025-07-24
FC_IL06,SKU000758,522,178,344,84,840,2025-07-27
FC_IL06,SKU001382,235,78,157,56,560,2025-07-22
FC_IL06,SKU001715,806,238,568,140,1400,2025-07-24
FC_IL06,SKU001164,1536,454,1082,210,2100,2025-07-24
FC_IL06,SKU001338,1612,452,1160,210,2100,2025-07-22
FC_IL06,SKU000611,834,238,596,140,1400,2025-07-27
FC_IL06,SKU000364,558,173,385,84,840,2025-07-27
FC_IL06,SKU001220,1584,502,1082,210,2100,2025-07-23
FC_IL06,SKU000645,613,169,444,112,1120,2025-07-25
FC_IL06,SKU000180,850,255,595,140,1400,2025-07-27
FC_IL06,SKU000086,534,169,365,84,840,2025-07-26
FC_IL06,SKU000741,275,92,183,56,560,2025-07-25
FC_IL06,SKU000552,1553,454,1099,210,2100,2025-07-22
FC_IL06,SKU001413,860,273,587,140,1400,2025-07-21
FC_IL06,SKU000171,1529,457,1072,210,2100,2025-07-26
FC_IL06,SKU001450,556,172,384,84,840,2025-07-24
FC_IL06,SKU001684,1515,423,1092,210,2100,2025-07-21
FC_IL06,SKU000207,1553,462,1091,210,2100,2025-07-24
FC_IL06,SKU001418,811,266,545,140,1400,2025-07-25
FC_IL06,SKU000001,485,144,341,84,840,2025-07-21
FC_IL06,SKU001559,1553,475,1078,210,2100,2025-07-22
FC_IL06,SKU000554,660,208,452,112,1120,2025-07-25
FC_IL06,SKU001825,545,158,387,84,840,2025-07-25
FC_IL06,SKU001992,264,80,184,56,560,2025-07-25
FC_IL06,SKU001618,828,247,581,140,1400,2025-07-22
FC_IL06,SKU001579,245,75,170,56,560,2025-07-21
FC_IL06,SKU000167,636,195,441,112,1120,2025-07-26
FC_IL06,SKU000387,1585,476,1109,210,2100,2025-07-24
FC_IL06,SKU001177,534,160,374,84,840,2025-07-27
FC_IL06,SKU001376,624,181,443,112,1120,2025-07-22
FC_IL06,SKU001131,814,244,570,140,1400,2025-07-27
FC_IL06,SKU001914,849,249,600,140,1400,2025-07-27
FC_IL06,SKU000115,1557,455,1102,210,2100,2025-07-25
FC_IL06,SKU001481,1566,486,1080,210,2100,2025-07-25
FC_IL06,SKU001819,562,177,385,84,840,2025-07-22
FC_IL06,SKU000202,607,203,404,112,1120,2025-07-22
FC_IL06,SKU000201,532,170,362,84,840,2025-07-25
FC_IL06,SKU001683,259,61,198,56,560,2025-07-27
FC_IL06,SKU001006,641,176,465,112,1120,2025-07-27
FC_IL06,SKU000950,543,185,358,84,840,2025-07-21
FC_IL06,SKU001172,934,278,656,140,1400,2025-07-21
FC_IL06,SKU001753,254,69,185,56,560,2025-07-26
FC_IL06,SKU001977,601,201,400,112,1120,2025-07-21
FC_IL06,SKU001128,1574,449,1125,210,2100,2025-07-27
FC_IL06,SKU000676,1566,466,1100,210,2100,2025-07-26
FC_IL06,SKU001111,836,242,594,140,1400,2025-07-22
FC_IL06,SKU000103,828,257,571,140,1400,2025-07-26
FC_IL06,SKU001829,1586,518,1068,210,2100,2025-07-21
FC_IL06,SKU000736,555,173,382,84,840,2025-07-21
FC_IL06,SKU000717,250,79,171,56,560,2025-07-23
FC_IL06,SKU000174,569,166,403,84,840,2025-07-26
FC_IL06,SKU000222,792,233,559,140,1400,2025-07-27
FC_IL06,SKU000094,1610,466,1144,210,2100,2025-07-23
FC_IL06,SKU000322,829,243,586,140,1400,2025-07-22
FC_IL06,SKU001723,864,235,629,140,1400,2025-07-25
FC_IL06,SKU001329,600,187,413,112,1120,2025-07-25
FC_IL06,SKU001993,607,166,441,84,840,2025-07-23
FC_IL06,SKU000525,601,197,404,112,1120,2025-07-24
FC_IL06,SKU001609,1549,473,1076,210,2100,2025-07-23
FC_IL06,SKU001077,227,70,157,56,560,2025-07-21
FC_IL06,SKU001184,584,173,411,112,1120,2025-07-25
FC_IL06,SKU001244,1606,483,1123,210,2100,2025-07-21
FC_IL06,SKU000338,619,197,422,112,1120,2025-07-25
FC_IL06,SKU000268,263,73,190,56,560,2025-07-21
FC_IL06,SKU001667,593,161,432,112,1120,2025-07-22
FC_IL06,SKU000802,546,154,392,84,840,2025-07-25
FC_IL06,SKU000762,828,256,572,140,1400,2025-07-26
FC_IL06,SKU000307,907,275,632,140,1400,2025-07-26
FC_IL06,SKU001036,1544,459,1085,210,2100,2025-07-21
FC_IL06,SKU001179,534,139,395,84,840,2025-07-25
FC_IL06,SKU001964,854,258,596,140,1400,2025-07-24
FC_IL06,SKU001192,865,253,612,140,1400,2025-07-23
FC_IL06,SKU001159,556,165,391,84,840,2025-07-25
FC_IL06,SKU000049,823,265,558,140,1400,2025-07-22
FC_IL06,SKU001827,777,232,545,140,1400,2025-07-25
FC_IL06,SKU001365,1571,487,1084,210,2100,2025-07-27
FC_IL06,SKU001716,826,262,564,140,1400,2025-07-22
FC_IL06,SKU001025,258,66,192,56,560,2025-07-21
FC_IL06,SKU001523,1539,499,1040,210,2100,2025-07-24
FC_IL06,SKU001515,1555,462,1093,210,2100,2025-07-26
FC_IL06,SKU000720,1561,471,1090,210,2100,2025-07-22
FC_IL06,SKU000639,553,182,371,84,840,2025-07-21
FC_IL06,SKU000433,250,65,185,56,560,2025-07-22
FC_IL06,SKU001017,843,268,575,140,1400,2025-07-24
FC_IL06,SKU001745,609,201,408,112,1120,2025-07-23
FC_IL06,SKU000464,274,68,206,56,560,2025-07-27
FC_IL06,SKU001391,574,178,396,84,840,2025-07-22
FC_IL06,SKU001104,641,179,462,112,1120,2025-07-21
FC_IL06,SKU000917,530,148,382,84,840,2025-07-26
FC_IL06,SKU001546,234,70,164,56,560,2025-07-23
FC_IL06,SKU000447,1504,443,1061,210,2100,2025-07-22
FC_IL06,SKU001758,573,175,398,84,840,2025-07-25
FC_IL06,SKU001363,245,86,159,56,560,2025-07-26
FC_IL06,SKU000549,524,159,365,84,840,2025-07-25
FC_IL06,SKU001370,839,260,579,140,1400,2025-07-22
FC_IL06,SKU001505,1535,389,1146,210,2100,2025-07-22
FC_IL06,SKU001233,612,175,437,112,1120,2025-07-23
FC_IL06,SKU000550,854,248,606,140,1400,2025-07-23
FC_IL06,SKU001449,1506,454,1052,210,2100,2025-07-21
FC_IL06,SKU000413,585,167,418,112,1120,2025-07-23
FC_IL06,SKU000372,546,152,394,84,840,2025-07-24
FC_IL06,SKU000230,265,98,167,56,560,2025-07-27
FC_IL06,SKU001186,538,168,370,84,840,2025-07-27
FC_IL06,SKU001920,853,257,596,140,1400,2025-07-21
FC_IL06,SKU001661,240,77,163,56,560,2025-07-24
FC_IL06,SKU001035,804,258,546,140,1400,2025-07-25
FC_IL06,SKU000542,615,202,413,112,1120,2025-07-24
FC_IL06,SKU001895,610,166,444,112,1120,2025-07-23
FC_IL06,SKU000740,563,182,381,84,840,2025-07-21
FC_IL06,SKU001854,251,69,182,56,560,2025-07-26
FC_IL06,SKU001940,1633,505,1128,210,2100,2025-07-22
FC_IL06,SKU001864,525,168,357,84,840,2025-07-21
FC_IL06,SKU001766,528,156,372,84,840,2025-07-21
FC_IL06,SKU001673,545,196,349,84,840,2025-07-24
FC_IL06,SKU000910,259,77,182,56,560,2025-07-25
FC_IL06,SKU000370,840,235,605,140,1400,2025-07-23
FC_IL06,SKU001602,806,253,553,140,1400,2025-07-21
FC_IL06,SKU001429,817,270,547,140,1400,2025-07-21
FC_IL06,SKU000927,544,172,372,84,840,2025-07-27
FC_IL06,SKU001360,1526,447,1079,210,2100,2025-07-25
FC_IL06,SKU001042,616,184,432,112,1120,2025-07-26
FC_IL06,SKU001264,247,77,170,56,560,2025-07-21
FC_IL06,SKU000790,247,67,180,56,560,2025-07-21
FC_IL06,SKU001310,270,82,188,56,560,2025-07-27
FC_IL06,SKU001802,561,170,391,84,840,2025-07-27
FC_IL06,SKU000114,265,69,196,56,560,2025-07-27
FC_IL06,SKU001033,822,255,567,140,1400,2025-07-27
FC_IL06,SKU000699,259,85,174,56,560,2025-07-23
FC_IL06,SKU001452,244,73,171,56,560,2025-07-25
FC_IL06,SKU001336,611,176,435,112,1120,2025-07-21
FC_IL06,SKU001603,259,79,180,56,560,2025-07-24
FC_IL06,SKU001899,1546,454,1092,210,2100,2025-07-24
FC_IL06,SKU001535,831,254,577,140,1400,2025-07-24
FC_IL06,SKU001765,815,219,596,140,1400,2025-07-25
FC_IL06,SKU001029,555,181,374,112,1120,2025-07-23
FC_IL06,SKU001514,259,83,176,56,560,2025-07-22
FC_IL06,SKU001842,573,180,393,112,1120,2025-07-27
FC_IL06,SKU001886,546,160,386,84,840,2025-07-22
FC_IL06,SKU001371,553,138,415,84,840,2025-07-23
FC_IL06,SKU000974,1553,467,1086,210,2100,2025-07-22
FC_IL06,SKU000291,1584,441,1143,210,2100,2025-07-22
FC_IL06,SKU001318,512,179,333,84,840,2025-07-25
FC_IL06,SKU000096,1463,451,1012,210,2100,2025-07-24
FC_IL06,SKU000384,235,57,178,56,560,2025-07-26
FC_IL06,SKU000938,242,72,170,56,560,2025-07-21
FC_IL06,SKU001648,246,70,176,56,560,2025-07-27
FC_IL06,SKU001931,578,175,403,84,840,2025-07-23
FC_IL06,SKU000121,518,192,326,84,840,2025-07-24
FC_IL06,SKU001456,623,189,434,112,1120,2025-07-22
FC_IL06,SKU001638,280,62,218,56,560,2025-07-23
FC_IL06,SKU000074,1575,501,1074,210,2100,2025-07-25
FC_IL06,SKU001898,568,180,388,84,840,2025-07-21
FC_IL06,SKU000197,1547,487,1060,210,2100,2025-07-25
FC_IL06,SKU000020,548,148,400,84,840,2025-07-24
FC_IL06,SKU000966,632,168,464,112,1120,2025-07-21
FC_IL06,SKU001076,670,210,460,112,1120,2025-07-26
FC_IL06,SKU001530,520,163,357,84,840,2025-07-25
FC_IL06,SKU000882,544,156,388,84,840,2025-07-24
FC_IL06,SKU000149,614,185,429,112,1120,2025-07-26
FC_IL06,SKU001764,1566,496,1070,210,2100,2025-07-22
FC_IL06,SKU000873,589,173,416,112,1120,2025-07-27
FC_IL06,SKU000401,863,229,634,140,1400,2025-07-25
FC_IL06,SKU001176,1553,454,1099,210,2100,2025-07-22
FC_IL06,SKU000444,530,155,375,84,840,2025-07-24
FC_IL06,SKU000213,230,70,160,56,560,2025-07-23
FC_IL06,SKU000481,1509,438,1071,210,2100,2025-07-25
FC_IL06,SKU000507,1570,414,1156,210,2100,2025-07-27
FC_IL06,SKU001016,527,147,380,84,840,2025-07-22
FC_IL06,SKU000246,819,269,550,140,1400,2025-07-23
FC_IL06,SKU001541,1584,444,1140,210,2100,2025-07-22
FC_IL06,SKU000632,832,238,594,140,1400,2025-07-24
FC_IL06,SKU001811,254,71,183,56,560,2025-07-25
FC_IL06,SKU001143,257,73,184,56,560,2025-07-23
FC_IL06,SKU001120,276,83,193,56,560,2025-07-24
FC_IL06,SKU001272,554,176,378,84,840,2025-07-27
FC_IL06,SKU000185,851,253,598,140,1400,2025-07-21
FC_IL06,SKU000761,589,191,398,112,1120,2025-07-26
FC_IL06,SKU001277,821,241,580,140,1400,2025-07-22
FC_IL06,SKU001058,270,89,181,56,560,2025-07-21
FC_IL06,SKU000373,259,99,160,56,560,2025-07-26
FC_IL06,SKU000285,539,161,378,84,840,2025-07-27
FC_IL06,SKU001769,247,76,171,56,560,2025-07-24
FC_IL06,SKU000015,1593,501,1092,210,2100,2025-07-25
FC_IL06,SKU001337,606,178,428,112,1120,2025-07-27
FC_IL06,SKU001890,620,175,445,112,1120,2025-07-24
FC_IL06,SKU001922,864,254,610,140,1400,2025-07-24
FC_IL06,SKU000852,259,66,193,56,560,2025-07-27
FC_IL06,SKU000258,1644,451,1193,210,2100,2025-07-24
FC_IL06,SKU000434,238,67,171,56,560,2025-07-21
FC_IL06,SKU000600,839,251,588,140,1400,2025-07-23
FC_IL06,SKU001856,278,87,191,56,560,2025-07-22
FC_IL06,SKU001156,870,251,619,140,1400,2025-07-22
FC_IL06,SKU001511,271,83,188,56,560,2025-07-26
FC_IL06,SKU001274,1634,487,1147,210,2100,2025-07-26
FC_IL06,SKU000710,236,66,170,56,560,2025-07-25
FC_IL06,SKU000212,857,253,604,140,1400,2025-07-21
FC_IL06,SKU000991,808,268,540,140,1400,2025-07-22
FC_IL06,SKU000385,625,193,432,112,1120,2025-07-22
FC_IL06,SKU001473,539,162,377,84,840,2025-07-27
FC_IL06,SKU001012,225,69,156,56,560,2025-07-21
FC_IL06,SKU001680,499,153,346,84,840,2025-07-26
FC_IL06,SKU001772,551,157,394,84,840,2025-07-26
FC_IL06,SKU000940,595,184,411,112,1120,2025-07-26
FC_IL06,SKU001231,835,241,594,140,1400,2025-07-22
FC_IL06,SKU000928,234,63,171,56,560,2025-07-25
FC_IL06,SKU000083,827,262,565,140,1400,2025-07-23
FC_IL06,SKU000868,885,256,629,140,1400,2025-07-26
FC_IL06,SKU001200,615,186,429,112,1120,2025-07-23
FC_IL06,SKU001706,223,54,169,56,560,2025-07-24
FC_IL06,SKU000376,1596,452,1144,210,2100,2025-07-24
FC_IL06,SKU001522,607,161,446,112,1120,2025-07-24
FC_IL06,SKU000472,255,90,165,56,560,2025-07-25
FC_IL06,SKU000877,1528,435,1093,210,2100,2025-07-22
FC_IL06,SKU000421,246,78,168,56,560,2025-07-21
FC_IL06,SKU000965,1600,484,1116,210,2100,2025-07-25
FC_IL06,SKU000482,1607,491,1116,210,2100,2025-07-26
FC_IL06,SKU000618,497,154,343,84,840,2025-07-26
FC_IL06,SKU000551,881,243,638,140,1400,2025-07-24
FC_IL06,SKU000923,234,64,170,56,560,2025-07-22
FC_IL06,SKU000187,570,183,387,84,840,2025-07-21
FC_IL06,SKU000484,830,248,582,140,1400,2025-07-21
FC_IL06,SKU000988,590,196,394,84,840,2025-07-27
FC_IL06,SKU001437,542,154,388,84,840,2025-07-23
FC_IL06,SKU000989,623,194,429,112,1120,2025-07-21
FC_IL06,SKU000593,856,257,599,140,1400,2025-07-26
FC_IL06,SKU001402,545,166,379,84,840,2025-07-23
FC_IL06,SKU000843,1622,488,1134,210,2100,2025-07-24
FC_IL06,SKU001229,270,88,182,56,560,2025-07-24
FC_IL06,SKU000652,800,235,565,140,1400,2025-07-23
FC_IL06,SKU000273,274,80,194,56,560,2025-07-26
FC_IL06,SKU001500,636,207,429,112,1120,2025-07-22
FC_IL06,SKU000567,597,209,388,84,840,2025-07-21
FC_IL06,SKU001952,872,259,613,140,1400,2025-07-27
FC_IL06,SKU001534,1547,474,1073,210,2100,2025-07-24
FC_IL06,SKU001180,868,287,581,140,1400,2025-07-23
FC_IL06,SKU001181,572,186,386,84,840,2025-07-25
FC_IL06,SKU001587,228,73,155,56,560,2025-07-26
FC_IL06,SKU000067,1581,479,1102,210,2100,2025-07-25
FC_IL06,SKU001848,812,244,568,140,1400,2025-07-24
FC_IL06,SKU000440,848,257,591,140,1400,2025-07-23
FC_IL06,SKU000081,566,181,385,84,840,2025-07-23
FC_IL06,SKU000046,829,235,594,140,1400,2025-07-26
FC_IL06,SKU000753,816,228,588,140,1400,2025-07-23
FC_IL06,SKU000150,875,252,623,140,1400,2025-07-25
FC_IL06,SKU000214,598,210,388,112,1120,2025-07-23
FC_IL06,SKU000315,656,195,461,112,1120,2025-07-24
FC_IL06,SKU000134,1573,453,1120,210,2100,2025-07-27
FC_IL06,SKU001855,1518,436,1082,210,2100,2025-07-26
FC_IL06,SKU000299,598,176,422,112,1120,2025-07-22
FC_IL06,SKU000962,566,160,406,84,840,2025-07-24
FC_IL06,SKU000282,652,212,440,112,1120,2025-07-27
FC_IL06,SKU000400,1635,511,1124,210,2100,2025-07-26
FC_IL06,SKU000009,508,143,365,84,840,2025-07-27
FC_IL06,SKU000402,1630,510,1120,210,2100,2025-07-27
FC_IL06,SKU001069,813,237,576,140,1400,2025-07-23
FC_IL06,SKU000939,657,172,485,112,1120,2025-07-23
FC_IL06,SKU001921,241,71,170,56,560,2025-07-22
FC_IL06,SKU000912,236,81,155,56,560,2025-07-25
FC_IL06,SKU000437,1551,451,1100,210,2100,2025-07-23
FC_IL06,SKU000191,1551,465,1086,210,2100,2025-07-25
FC_IL06,SKU001664,290,93,197,56,560,2025-07-21
FC_IL06,SKU000718,510,176,334,84,840,2025-07-23
FC_IL06,SKU001838,1556,455,1101,210,2100,2025-07-23
FC_IL06,SKU001730,239,57,182,56,560,2025-07-26
FC_IL06,SKU001970,851,253,598,140,1400,2025-07-26
FC_IL06,SKU001366,1609,475,1134,210,2100,2025-07-24
FC_IL06,SKU001721,891,260,631,140,1400,2025-07-25
FC_IL06,SKU000959,256,89,167,56,560,2025-07-21
FC_IL06,SKU001976,223,60,163,56,560,2025-07-23
FC_IL06,SKU001595,1581,449,1132,210,2100,2025-07-23
FC_IL06,SKU001373,267,72,195,56,560,2025-07-27
FC_IL06,SKU000742,250,83,167,56,560,2025-07-24
FC_IL06,SKU001000,1543,490,1053,210,2100,2025-07-26
FC_IL06,SKU000589,620,174,446,112,1120,2025-07-22
FC_IL06,SKU000143,625,180,445,112,1120,2025-07-23
FC_IL06,SKU001386,551,147,404,84,840,2025-07-26
FC_IL06,SKU000388,599,192,407,112,1120,2025-07-21
FC_IL06,SKU000511,264,77,187,56,560,2025-07-25
FC_IL06,SKU001576,845,261,584,140,1400,2025-07-27
FC_IL06,SKU001887,278,87,191,56,560,2025-07-26
FC_IL06,SKU000707,260,101,159,56,560,2025-07-26
FC_IL06,SKU001490,537,163,374,84,840,2025-07-25
FC_IL06,SKU001240,1557,466,1091,210,2100,2025-07-22
FC_IL06,SKU000203,571,173,398,84,840,2025-07-22
FC_IL06,SKU001305,1569,465,1104,210,2100,2025-07-23
FC_IL06,SKU000374,606,185,421,112,1120,2025-07-22
FC_IL06,SKU000037,616,181,435,112,1120,2025-07-22
FC_IL06,SKU000929,1607,462,1145,210,2100,2025-07-21
FC_IL06,SKU000841,262,73,189,56,560,2025-07-21
FC_IL06,SKU001955,243,84,159,56,560,2025-07-24
FC_IL06,SKU001939,555,158,397,84,840,2025-07-21
FC_IL06,SKU000169,638,181,457,112,1120,2025-07-22
FC_IL06,SKU001046,586,190,396,112,1120,2025-07-23
FC_IL06,SKU001937,239,70,169,56,560,2025-07-24
FC_IL06,SKU000859,636,193,443,112,1120,2025-07-22
FC_IL06,SKU001717,271,88,183,56,560,2025-07-21
FC_IL06,SKU000077,1579,456,1123,210,2100,2025-07-23
FC_IL06,SKU000476,580,186,394,84,840,2025-07-23
FC_IL06,SKU000110,804,231,573,140,1400,2025-07-27
FC_IL06,SKU001232,1592,494,1098,210,2100,2025-07-26
FC_IL06,SKU000727,1556,446,1110,210,2100,2025-07-23
FC_IL06,SKU000667,232,68,164,56,560,2025-07-27
FC_IL06,SKU000396,239,68,171,56,560,2025-07-24
FC_IL06,SKU000649,529,173,356,84,840,2025-07-25
FC_IL06,SKU001404,1576,432,1144,210,2100,2025-07-23
FC_IL06,SKU001308,559,161,398,84,840,2025-07-25
FC_IL06,SKU000757,234,52,182,56,560,2025-07-21
FC_IL06,SKU001074,239,64,175,56,560,2025-07-21
FC_IL06,SKU000172,258,75,183,56,560,2025-07-22
FC_IL06,SKU001743,821,248,573,140,1400,2025-07-22
FC_IL06,SKU000726,277,73,204,56,560,2025-07-24
FC_IL06,SKU001727,809,236,573,140,1400,2025-07-25
FC_IL06,SKU001972,262,70,192,56,560,2025-07-23
FC_IL06,SKU001582,841,247,594,140,1400,2025-07-27
FC_IL06,SKU000183,605,169,436,112,1120,2025-07-23
FC_IL06,SKU001175,808,253,555,140,1400,2025-07-25
FC_IL06,SKU001055,609,172,437,112,1120,2025-07-25
FC_IL06,SKU001869,527,162,365,84,840,2025-07-26
FC_IL06,SKU000532,599,178,421,112,1120,2025-07-27
FC_IL06,SKU001626,1470,409,1061,210,2100,2025-07-24
FC_IL06,SKU000336,539,174,365,84,840,2025-07-23
FC_IL06,SKU001718,562,134,428,84,840,2025-07-25
FC_IL06,SKU001996,570,174,396,84,840,2025-07-25
FC_IL06,SKU000405,1596,495,1101,210,2100,2025-07-27
FC_IL06,SKU000474,858,237,621,140,1400,2025-07-25
FC_IL06,SKU000750,594,170,424,112,1120,2025-07-24
FC_IL06,SKU001078,856,245,611,140,1400,2025-07-21
FC_IL06,SKU000643,833,230,603,140,1400,2025-07-26
FC_IL06,SKU000985,540,179,361,84,840,2025-07-27
FC_IL06,SKU000069,1627,458,1169,210,2100,2025-07-24
FC_IL06,SKU001732,1592,456,1136,210,2100,2025-07-22
FC_IL06,SKU001843,658,194,464,112,1120,2025-07-23
FC_IL06,SKU000606,856,280,576,140,1400,2025-07-24
FC_IL06,SKU000663,259,75,184,56,560,2025-07-24
FC_IL06,SKU001140,828,262,566,140,1400,2025-07-24
FC_IL06,SKU000199,588,177,411,112,1120,2025-07-24
FC_IL06,SKU000672,644,180,464,112,1120,2025-07-24
FC_IL06,SKU001283,811,233,578,140,1400,2025-07-22
FC_IL06,SKU000238,1580,493,1087,210,2100,2025-07-25
FC_IL06,SKU001756,263,99,164,56,560,2025-07-27
FC_IL06,SKU000301,647,179,468,112,1120,2025-07-27
FC_IL06,SKU000498,270,82,188,56,560,2025-07-23
FC_IL06,SKU001129,795,239,556,140,1400,2025-07-26
FC_IL06,SKU001419,244,76,168,56,560,2025-07-24
FC_IL06,SKU000125,1581,476,1105,210,2100,2025-07-24
FC_IL06,SKU001090,255,68,187,56,560,2025-07-22
FC_IL06,SKU001647,588,180,408,84,840,2025-07-27
FC_IL06,SKU001323,848,239,609,140,1400,2025-07-23
FC_IL06,SKU000715,540,170,370,84,840,2025-07-22
FC_IL06,SKU000076,860,265,595,140,1400,2025-07-27
FC_IL06,SKU000506,619,168,451,112,1120,2025-07-27
FC_IL06,SKU001435,643,199,444,112,1120,2025-07-27
FC_IL06,SKU001089,506,137,369,84,840,2025-07-25
FC_IL06,SKU000656,1552,472,1080,210,2100,2025-07-22
FC_IL06,SKU000875,273,84,189,56,560,2025-07-25
FC_IL06,SKU001267,839,253,586,140,1400,2025-07-26
FC_IL06,SKU001694,257,94,163,56,560,2025-07-25
FC_IL06,SKU000466,783,234,549,140,1400,2025-07-23
FC_IL06,SKU000681,1613,484,1129,210,2100,2025-07-23
FC_IL06,SKU000439,247,73,174,56,560,2025-07-24
FC_IL06,SKU000267,623,180,443,112,1120,2025-07-23
FC_IL06,SKU000449,259,72,187,56,560,2025-07-27
FC_IL06,SKU001900,570,183,387,84,840,2025-07-21
FC_IL06,SKU001719,641,187,454,112,1120,2025-07-21
FC_IL06,SKU000789,589,178,411,112,1120,2025-07-22
FC_IL06,SKU001346,886,276,610,140,1400,2025-07-25
FC_IL06,SKU000423,1562,515,1047,210,2100,2025-07-24
FC_IL06,SKU000785,515,147,368,84,840,2025-07-22
FC_IL06,SKU000765,621,188,433,112,1120,2025-07-25
FC_IL06,SKU001847,534,160,374,84,840,2025-07-27
FC_IL06,SKU000849,1595,499,1096,210,2100,2025-07-23
FC_IL06,SKU001061,525,168,357,84,840,2025-07-24
FC_IL06,SKU001165,562,199,363,84,840,2025-07-26
FC_IL06,SKU001507,1582,504,1078,210,2100,2025-07-26
FC_IL06,SKU000635,569,173,396,84,840,2025-07-21
FC_IL06,SKU000477,527,158,369,84,840,2025-07-25
FC_IL06,SKU000971,1593,469,1124,210,2100,2025-07-24
FC_IL06,SKU001066,555,178,377,84,840,2025-07-27
FC_IL06,SKU000249,658,201,457,112,1120,2025-07-22
FC_IL06,SKU000142,247,76,171,56,560,2025-07-21
FC_IL06,SKU002000,546,161,385,84,840,2025-07-24
FC_IL06,SKU000119,1589,522,1067,210,2100,2025-07-21
FC_IL06,SKU000612,505,154,351,84,840,2025-07-26
FC_IL06,SKU001956,1536,475,1061,210,2100,2025-07-25
FC_IL06,SKU000205,1621,491,1130,210,2100,2025-07-24
FC_IL06,SKU000607,525,171,354,84,840,2025-07-26
FC_IL06,SKU000861,539,156,383,84,840,2025-07-25
FC_IL06,SKU000582,847,237,610,140,1400,2025-07-25
FC_IL06,SKU001892,281,86,195,56,560,2025-07-22
FC_IL06,SKU000178,503,145,358,84,840,2025-07-23
FC_IL06,SKU000853,1579,509,1070,210,2100,2025-07-26
FC_IL06,SKU001928,641,208,433,112,1120,2025-07-26
FC_IL06,SKU001188,854,247,607,140,1400,2025-07-24
FC_IL06,SKU000100,549,169,380,84,840,2025-07-21
FC_IL06,SKU000795,841,252,589,140,1400,2025-07-26
FC_IL06,SKU001001,1628,466,1162,210,2100,2025-07-25
FC_IL06,SKU000926,207,57,150,56,560,2025-07-23
FC_IL06,SKU000099,858,276,582,140,1400,2025-07-25
FC_IL06,SKU001874,1576,454,1122,210,2100,2025-07-22
FC_IL06,SKU001807,533,143,390,84,840,2025-07-23
FC_IL06,SKU001445,613,170,443,112,1120,2025-07-27
FC_IL06,SKU000041,607,189,418,112,1120,2025-07-24
FC_IL06,SKU001593,850,256,594,140,1400,2025-07-24
FC_IL06,SKU000038,1585,447,1138,210,2100,2025-07-25
FC_IL06,SKU001818,1593,493,1100,210,2100,2025-07-26
FC_IL06,SKU000243,628,192,436,112,1120,2025-07-22
FC_IL06,SKU000274,553,151,402,84,840,2025-07-27
FC_IL06,SKU000842,633,211,422,112,1120,2025-07-23
FC_IL06,SKU001170,857,238,619,140,1400,2025-07-23
FC_IL06,SKU001468,623,178,445,112,1120,2025-07-24
FC_IL06,SKU000655,1570,489,1081,210,2100,2025-07-24
FC_IL06,SKU000002,562,152,410,84,840,2025-07-26
FC_IL06,SKU001482,878,267,611,140,1400,2025-07-25
FC_IL06,SKU000791,641,177,464,112,1120,2025-07-22
FC_IL06,SKU000075,1594,478,1116,210,2100,2025-07-25
FC_IL06,SKU000509,1546,465,1081,210,2100,2025-07-27
FC_IL06,SKU001462,1480,453,1027,210,2100,2025-07-22
FC_IL06,SKU001790,260,74,186,56,560,2025-07-22
FC_IL06,SKU001509,642,175,467,112,1120,2025-07-23
FC_IL06,SKU001252,632,203,429,112,1120,2025-07-21
FC_IL06,SKU000597,532,176,356,84,840,2025-07-24
FC_IL06,SKU001065,1564,456,1108,210,2100,2025-07-26
FC_IL06,SKU001466,580,156,424,84,840,2025-07-25
FC_IL06,SKU000538,825,229,596,140,1400,2025-07-21
FC_IL06,SKU000452,865,247,618,140,1400,2025-07-25
FC_IL06,SKU001519,549,173,376,84,840,2025-07-27
FC_IL06,SKU000987,1613,509,1104,210,2100,2025-07-26
FC_IL06,SKU001021,530,154,376,84,840,2025-07-26
FC_IL06,SKU001973,538,175,363,84,840,2025-07-25
FC_IL06,SKU001640,576,193,383,112,1120,2025-07-25
FC_IL06,SKU000697,633,176,457,112,1120,2025-07-26
FC_IL06,SKU001883,1468,426,1042,210,2100,2025-07-22
FC_IL06,SKU001085,831,244,587,140,1400,2025-07-23
FC_IL06,SKU000460,1615,500,1115,210,2100,2025-07-24
FC_IL06,SKU001340,782,237,545,140,1400,2025-07-27
FC_IL06,SKU000913,1667,544,1123,210,2100,2025-07-27
FC_IL06,SKU001425,611,199,412,112,1120,2025-07-23
FC_IL06,SKU000907,541,159,382,84,840,2025-07-23
FC_IL06,SKU001614,870,251,619,140,1400,2025-07-24
FC_IL06,SKU000244,1630,520,1110,210,2100,2025-07-24
FC_IL06,SKU001999,267,60,207,56,560,2025-07-22
FC_IL06,SKU000156,245,63,182,56,560,2025-07-24
FC_IL06,SKU001416,1516,462,1054,210,2100,2025-07-25
FC_IL06,SKU001774,1576,449,1127,210,2100,2025-07-26
FC_IL06,SKU000703,544,164,380,84,840,2025-07-25
FC_IL06,SKU001130,1557,474,1083,210,2100,2025-07-23
FC_IL06,SKU001117,613,197,416,112,1120,2025-07-27
FC_IL06,SKU001401,554,164,390,84,840,2025-07-22
FC_IL06,SKU000659,242,65,177,56,560,2025-07-25
FC_IL06,SKU000017,548,169,379,84,840,2025-07-23
FC_IL06,SKU001426,581,192,389,112,1120,2025-07-22
FC_IL06,SKU001224,567,159,408,84,840,2025-07-24
FC_IL06,SKU001773,268,99,169,56,560,2025-07-23
FC_IL06,SKU001485,617,194,423,112,1120,2025-07-26
FC_IL06,SKU001105,1603,490,1113,210,2100,2025-07-23
FC_IL06,SKU000948,1609,482,1127,210,2100,2025-07-25
FC_IL06,SKU000646,583,183,400,112,1120,2025-07-22
FC_IL06,SKU000263,849,264,585,140,1400,2025-07-21
FC_IL06,SKU000897,258,73,185,56,560,2025-07-27
FC_IL06,SKU000782,866,269,597,140,1400,2025-07-23
FC_IL06,SKU000417,254,66,188,56,560,2025-07-22
FC_IL06,SKU001410,232,61,171,56,560,2025-07-21
FC_IL06,SKU000934,522,140,382,84,840,2025-07-25
FC_IL06,SKU000668,867,237,630,140,1400,2025-07-27
FC_IL06,SKU001737,807,236,571,140,1400,2025-07-26
FC_IL06,SKU000830,264,92,172,56,560,2025-07-26
FC_IL06,SKU000358,261,97,164,56,560,2025-07-24
FC_IL06,SKU000186,621,178,443,112,1120,2025-07-24
FC_IL06,SKU000459,805,300,505,140,1400,2025-07-26
FC_IL06,SKU000503,248,74,174,56,560,2025-07-27
FC_IL06,SKU000585,267,81,186,56,560,2025-07-26
FC_IL06,SKU000139,1508,449,1059,210,2100,2025-07-27
FC_IL06,SKU000627,551,168,383,84,840,2025-07-26
FC_IL06,SKU001685,1609,475,1134,210,2100,2025-07-23
FC_IL06,SKU000109,577,173,404,112,1120,2025-07-22
FC_IL06,SKU001088,551,167,384,84,840,2025-07-21
FC_IL06,SKU001540,817,251,566,140,1400,2025-07-26
FC_IL06,SKU001805,841,229,612,140,1400,2025-07-21
FC_IL06,SKU001959,832,251,581,140,1400,2025-07-27
FC_IL06,SKU001258,621,171,450,112,1120,2025-07-22
FC_IL06,SKU001979,540,160,380,84,840,2025-07-22
FC_IL06,SKU001008,551,156,395,84,840,2025-07-25
FC_IL06,SKU001447,845,231,614,140,1400,2025-07-24
FC_IL06,SKU001475,272,79,193,56,560,2025-07-24
FC_IL06,SKU000693,255,96,159,56,560,2025-07-22
FC_IL06,SKU001301,615,194,421,112,1120,2025-07-27
FC_IL06,SKU001788,249,77,172,56,560,2025-07-22
FC_IL06,SKU000292,566,166,400,84,840,2025-07-25
FC_IL06,SKU001199,258,79,179,56,560,2025-07-27
FC_IL06,SKU000942,597,179,418,112,1120,2025-07-21
FC_IL06,SKU000442,252,77,175,56,560,2025-07-27
FC_IL06,SKU001643,570,170,400,84,840,2025-07-26
FC_IL06,SKU001628,579,158,421,112,1120,2025-07-21
FC_IL06,SKU000698,1605,480,1125,210,2100,2025-07-22
FC_IL06,SKU000327,835,232,603,140,1400,2025-07-25
FC_IL06,SKU000453,1628,493,1135,210,2100,2025-07-23
FC_IL06,SKU000377,562,160,402,84,840,2025-07-27
FC_IL06,SKU001950,829,249,580,140,1400,2025-07-27
FC_IL06,SKU000666,870,260,610,140,1400,2025-07-26
FC_IL06,SKU001287,584,183,401,84,840,2025-07-24
FC_IL06,SKU000669,240,65,175,56,560,2025-07-21
FC_IL06,SKU001299,647,195,452,112,1120,2025-07-25
FC_IL06,SKU001575,286,89,197,56,560,2025-07-24
FC_IL06,SKU001281,1582,466,1116,210,2100,2025-07-21
FC_IL06,SKU000605,507,138,369,84,840,2025-07-21
FC_IL06,SKU000527,254,81,173,56,560,2025-07-24
FC_IL06,SKU000512,505,141,364,84,840,2025-07-27
FC_IL06,SKU001132,621,165,456,112,1120,2025-07-24
FC_IL06,SKU000835,1658,508,1150,210,2100,2025-07-22
FC_IL06,SKU000293,599,159,440,112,1120,2025-07-22
FC_IL06,SKU001342,523,151,372,84,840,2025-07-26
FC_IL06,SKU001446,227,71,156,56,560,2025-07-24
FC_IL06,SKU001512,262,66,196,56,560,2025-07-23
FC_IL06,SKU001529,617,163,454,112,1120,2025-07-25
FC_IL06,SKU001981,239,63,176,56,560,2025-07-21
FC_IL06,SKU000914,237,79,158,56,560,2025-07-24
FC_IL06,SKU000333,605,201,404,112,1120,2025-07-22
FC_IL06,SKU001750,1613,510,1103,210,2100,2025-07-22
FC_IL06,SKU001850,227,72,155,56,560,2025-07-26
FC_IL06,SKU001653,1537,452,1085,210,2100,2025-07-24
FC_IL06,SKU001797,1500,472,1028,210,2100,2025-07-21
FC_IL06,SKU000217,244,82,162,56,560,2025-07-24
FC_IL06,SKU000570,1660,494,1166,210,2100,2025-07-25
FC_IL06,SKU001674,853,255,598,140,1400,2025-07-21
FC_IL06,SKU000004,1602,481,1121,210,2100,2025-07-23
FC_IL06,SKU000380,631,184,447,112,1120,2025-07-23
FC_IL06,SKU001565,519,150,369,84,840,2025-07-27
FC_IL06,SKU001604,258,70,188,56,560,2025-07-24
FC_IL06,SKU001938,1630,500,1130,210,2100,2025-07-27
FC_IL06,SKU001100,595,162,433,112,1120,2025-07-27
FC_IL06,SKU000485,583,187,396,84,840,2025-07-23
FC_IL06,SKU000504,491,158,333,84,840,2025-07-26
FC_IL06,SKU001345,814,219,595,140,1400,2025-07-21
FC_IL06,SKU000505,528,157,371,84,840,2025-07-27
FC_IL06,SKU001668,251,77,174,56,560,2025-07-22
FC_IL06,SKU000658,1623,462,1161,210,2100,2025-07-21
FC_IL06,SKU001080,238,76,162,56,560,2025-07-23
FC_IL06,SKU000573,1574,510,1064,210,2100,2025-07-25
FC_IL06,SKU000916,263,70,193,56,560,2025-07-26
FC_IL06,SKU001649,590,152,438,112,1120,2025-07-24
FC_IL06,SKU001388,550,169,381,84,840,2025-07-23
FC_IL06,SKU000755,561,172,389,84,840,2025-07-22
FC_IL06,SKU000382,677,215,462,112,1120,2025-07-27
FC_IL06,SKU001037,620,195,425,112,1120,2025-07-27
FC_IL06,SKU000241,1536,474,1062,210,2100,2025-07-22
FC_IL06,SKU000231,853,281,572,140,1400,2025-07-21
FC_IL06,SKU001414,1610,473,1137,210,2100,2025-07-21
FC_IL06,SKU000810,644,191,453,112,1120,2025-07-24
FC_IL06,SKU000039,620,191,429,112,1120,2025-07-23
FC_IL06,SKU000568,253,61,192,56,560,2025-07-24
FC_IL06,SKU001121,234,76,158,56,560,2025-07-25
FC_IL06,SKU000774,1580,482,1098,210,2100,2025-07-21
FC_IL06,SKU001678,266,71,195,56,560,2025-07-22
FC_IL06,SKU000227,241,80,161,56,560,2025-07-22
FC_IL06,SKU001581,833,267,566,140,1400,2025-07-27
FC_IL06,SKU001945,1582,507,1075,210,2100,2025-07-25
FC_IL06,SKU000159,812,229,583,140,1400,2025-07-24
FC_IL06,SKU000304,893,265,628,140,1400,2025-07-27
FC_IL06,SKU001496,260,79,181,56,560,2025-07-27
FC_IL06,SKU000798,570,159,411,84,840,2025-07-26
FC_IL06,SKU000393,293,83,210,56,560,2025-07-23
FC_IL06,SKU000851,556,185,371,84,840,2025-07-25
FC_IL06,SKU000556,616,180,436,112,1120,2025-07-23
FC_IL06,SKU000629,1547,449,1098,210,2100,2025-07-22
FC_IL06,SKU000935,1553,443,1110,210,2100,2025-07-25
FC_IL06,SKU000803,612,175,437,112,1120,2025-07-21
FC_IL06,SKU001733,663,196,467,112,1120,2025-07-27
FC_IL06,SKU000025,504,162,342,84,840,2025-07-21
FC_IL06,SKU000947,653,197,456,112,1120,2025-07-21
FC_IL06,SKU000979,861,270,591,140,1400,2025-07-27
FC_IL06,SKU000769,635,206,429,112,1120,2025-07-26
FC_IL06,SKU001550,257,89,168,56,560,2025-07-26
FC_IL06,SKU000080,879,246,633,140,1400,2025-07-26
FC_IL06,SKU001652,247,69,178,56,560,2025-07-21
FC_IL06,SKU000398,271,75,196,56,560,2025-07-24
FC_IL06,SKU001533,619,205,414,112,1120,2025-07-22
FC_IL06,SKU001656,839,256,583,140,1400,2025-07-25
FC_IL06,SKU001948,612,207,405,112,1120,2025-07-26
FC_IL06,SKU001492,237,72,165,56,560,2025-07-21
FC_IL06,SKU000863,523,167,356,84,840,2025-07-23
FC_IL06,SKU000813,545,157,388,84,840,2025-07-24
FC_IL06,SKU000731,585,200,385,84,840,2025-07-24
FC_IL06,SKU001454,1550,481,1069,210,2100,2025-07-21
FC_IL06,SKU001853,512,158,354,84,840,2025-07-25
FC_IL06,SKU001484,547,162,385,84,840,2025-07-24
FC_IL06,SKU001538,818,229,589,140,1400,2025-07-22
FC_IL06,SKU001234,590,189,401,112,1120,2025-07-27
FC_IL06,SKU000845,536,154,382,84,840,2025-07-22
FC_IL06,SKU000508,550,152,398,84,840,2025-07-23
FC_IL06,SKU001216,623,186,437,112,1120,2025-07-25
FC_IL06,SKU000084,577,183,394,112,1120,2025-07-27
FC_IL06,SKU000826,820,241,579,140,1400,2025-07-27
FC_IL06,SKU001584,673,210,463,112,1120,2025-07-24
FC_IL06,SKU001260,815,223,592,140,1400,2025-07-27
FC_IL06,SKU000070,1576,479,1097,210,2100,2025-07-27
FC_IL06,SKU000856,843,219,624,140,1400,2025-07-26
FC_IL06,SKU000406,534,150,384,84,840,2025-07-25
FC_IL06,SKU001471,806,255,551,140,1400,2025-07-21
FC_IL06,SKU000744,894,275,619,140,1400,2025-07-27
FC_IL06,SKU001263,830,277,553,140,1400,2025-07-26
FC_IL06,SKU000722,607,172,435,112,1120,2025-07-24
FC_IL06,SKU001594,805,212,593,140,1400,2025-07-27
FC_IL06,SKU001187,253,67,186,56,560,2025-07-24
FC_IL06,SKU000922,264,78,186,56,560,2025-07-21
FC_IL06,SKU001007,547,164,383,84,840,2025-07-23
FC_IL06,SKU000596,542,176,366,84,840,2025-07-21
FC_IL06,SKU001688,624,180,444,112,1120,2025-07-22
FC_IL06,SKU001242,825,259,566,140,1400,2025-07-23
FC_IL06,SKU001995,566,164,402,84,840,2025-07-24
FC_IL06,SKU001606,816,255,561,140,1400,2025-07-27
FC_IL06,SKU001617,551,151,400,84,840,2025-07-25
FC_IL06,SKU000056,534,149,385,84,840,2025-07-21
FC_IL06,SKU001384,1504,482,1022,210,2100,2025-07-25
FC_IL06,SKU001836,1566,494,1072,210,2100,2025-07-23
FC_IL06,SKU001479,592,211,381,112,1120,2025-07-27
FC_IL06,SKU001351,832,268,564,140,1400,2025-07-21
FC_IL06,SKU000895,541,153,388,84,840,2025-07-25
FC_IL06,SKU000543,863,261,602,140,1400,2025-07-22
FC_IL06,SKU001784,586,163,423,112,1120,2025-07-26
FC_IL06,SKU000124,245,72,173,56,560,2025-07-22
FC_IL06,SKU001225,602,170,432,112,1120,2025-07-23
FC_IL06,SKU001390,536,164,372,84,840,2025-07-25
FC_IL06,SKU000819,843,267,576,140,1400,2025-07-22
FC_IL06,SKU000416,260,77,183,56,560,2025-07-25
FC_IL06,SKU001494,620,199,421,112,1120,2025-07-24
FC_IL06,SKU001536,237,78,159,56,560,2025-07-23
FC_IL06,SKU001754,576,174,402,84,840,2025-07-25
FC_IL06,SKU000677,262,72,190,56,560,2025-07-22
FC_IL06,SKU001592,647,186,461,112,1120,2025-07-22
FC_IL06,SKU001531,543,157,386,84,840,2025-07-23
FC_IL06,SKU001237,538,154,384,84,840,2025-07-27
FC_IL06,SKU000594,1562,444,1118,210,2100,2025-07-27
FC_IL06,SKU001385,608,205,403,112,1120,2025-07-26
FC_IL06,SKU001817,567,160,407,84,840,2025-07-21
FC_IL06,SKU001713,646,204,442,112,1120,2025-07-24
FC_IL06,SKU001987,254,77,177,56,560,2025-07-26
FC_IL06,SKU000286,891,265,626,140,1400,2025-07-22
FC_IL06,SKU000617,242,71,171,56,560,2025-07-26
FC_IL06,SKU000986,1578,481,1097,210,2100,2025-07-22
FC_IL06,SKU001623,643,211,432,112,1120,2025-07-27
FC_IL06,SKU001420,551,179,372,84,840,2025-07-24
FC_IL06,SKU001978,877,278,599,140,1400,2025-07-27
FC_IL06,SKU000184,525,168,357,84,840,2025-07-25
FC_IL06,SKU001894,520,179,341,84,840,2025-07-24
FC_IL06,SKU001545,536,173,363,84,840,2025-07-27
FC_IL06,SKU001041,650,204,446,112,1120,2025-07-26
FC_IL06,SKU001746,815,237,578,140,1400,2025-07-21
FC_IL06,SKU001670,573,195,378,84,840,2025-07-21
FC_IL06,SKU000349,665,182,483,112,1120,2025-07-27
FC_IL06,SKU001157,1552,440,1112,210,2100,2025-07-26
FC_IL06,SKU000237,1658,473,1185,210,2100,2025-07-24
FC_IL06,SKU000403,251,82,169,56,560,2025-07-25
FC_IL06,SKU000256,641,224,417,112,1120,2025-07-22
FC_IL06,SKU000182,1627,511,1116,210,2100,2025-07-24
FC_IL06,SKU000314,1579,498,1081,210,2100,2025-07-25
FC_IL06,SKU001147,591,190,401,112,1120,2025-07-27
FC_IL06,SKU001564,619,202,417,112,1120,2025-07-24
FC_IL06,SKU000872,818,239,579,140,1400,2025-07-27
FC_IL06,SKU000418,548,161,387,84,840,2025-07-23
FC_IL06,SKU000704,545,161,384,84,840,2025-07-27
FC_IL06,SKU000647,235,65,170,56,560,2025-07-25
FC_IL06,SKU000857,1537,483,1054,210,2100,2025-07-25
FC_IL06,SKU001134,1606,482,1124,210,2100,2025-07-21
FC_IL06,SKU001302,604,206,398,112,1120,2025-07-22
FC_IL06,SKU001428,1546,432,1114,210,2100,2025-07-26
FC_IL06,SKU000138,618,174,444,112,1120,2025-07-26
FC_IL06,SKU001747,246,72,174,56,560,2025-07-27
FC_IL06,SKU001145,541,159,382,84,840,2025-07-25
FC_IL06,SKU000887,252,73,179,56,560,2025-07-27
FC_IL06,SKU001591,543,172,371,84,840,2025-07-26
FC_IL06,SKU000896,859,297,562,140,1400,2025-07-26
FC_IL06,SKU001113,834,246,588,140,1400,2025-07-26
FC_IL06,SKU001320,885,255,630,140,1400,2025-07-27
FC_IL06,SKU001166,657,190,467,112,1120,2025-07-25
FC_IL06,SKU001162,655,234,421,112,1120,2025-07-23
FC_IL06,SKU000854,1552,489,1063,210,2100,2025-07-22
FC_IL06,SKU000219,246,61,185,56,560,2025-07-24
FC_IL06,SKU000777,1552,508,1044,210,2100,2025-07-26
FC_IL06,SKU000817,1620,466,1154,210,2100,2025-07-25
FC_IL06,SKU000621,234,72,162,56,560,2025-07-23
FC_IL06,SKU001872,241,66,175,56,560,2025-07-23
FC_IL06,SKU000723,592,190,402,112,1120,2025-07-21
FC_IL06,SKU001917,1586,474,1112,210,2100,2025-07-23
FC_IL06,SKU001027,1633,514,1119,210,2100,2025-07-25
FC_IL06,SKU000628,258,90,168,56,560,2025-07-21
FC_IL06,SKU001889,1587,482,1105,210,2100,2025-07-27
FC_IL06,SKU001891,250,87,163,56,560,2025-07-27
FC_IL06,SKU000350,844,247,597,140,1400,2025-07-23
FC_IL06,SKU001897,229,77,152,56,560,2025-07-22
FC_IL06,SKU001958,613,171,442,112,1120,2025-07-25
FC_IL06,SKU000300,1571,509,1062,210,2100,2025-07-21
FC_IL06,SKU001139,1609,456,1153,210,2100,2025-07-24
FC_IL06,SKU001969,595,205,390,112,1120,2025-07-27
FC_IL06,SKU001816,238,80,158,56,560,2025-07-25
FC_IL06,SKU000226,247,55,192,56,560,2025-07-22
FC_IL06,SKU001631,820,236,584,140,1400,2025-07-25
FC_IL06,SKU001396,612,185,427,112,1120,2025-07-26
FC_IL06,SKU000891,553,150,403,84,840,2025-07-24
FC_IL06,SKU000141,1558,481,1077,210,2100,2025-07-22
FC_IL06,SKU000257,626,178,448,112,1120,2025-07-23
FC_IL06,SKU000479,833,252,581,140,1400,2025-07-25
FC_IL06,SKU000579,625,169,456,112,1120,2025-07-27
FC_IL06,SKU001408,1632,485,1147,210,2100,2025-07-23
FC_IL06,SKU001586,1564,453,1111,210,2100,2025-07-26
FC_IL06,SKU001583,541,143,398,84,840,2025-07-27
FC_IL06,SKU001662,1561,432,1129,210,2100,2025-07-21
FC_IL06,SKU001210,849,227,622,140,1400,2025-07-23
FC_IL06,SKU000708,832,261,571,140,1400,2025-07-26
FC_IL06,SKU000586,648,183,465,112,1120,2025-07-21
FC_IL06,SKU001010,274,88,186,56,560,2025-07-26
FC_IL06,SKU001463,578,139,439,112,1120,2025-07-21
FC_IL06,SKU001708,832,250,582,140,1400,2025-07-27
FC_IL06,SKU001588,563,170,393,84,840,2025-07-26
FC_IL06,SKU000198,1620,502,1118,210,2100,2025-07-24
FC_IL06,SKU000563,879,264,615,140,1400,2025-07-27
FC_IL06,SKU000588,778,216,562,140,1400,2025-07-27
FC_IL06,SKU000194,644,196,448,112,1120,2025-07-21
FC_IL06,SKU001303,1578,462,1116,210,2100,2025-07-26
FC_IL06,SKU001813,875,247,628,140,1400,2025-07-24
FC_IL06,SKU000767,872,277,595,140,1400,2025-07-25
FC_IL06,SKU000475,560,174,386,84,840,2025-07-22
FC_IL06,SKU000949,901,256,645,140,1400,2025-07-22
FC_IL06,SKU000489,1605,526,1079,210,2100,2025-07-21
FC_IL06,SKU001613,639,199,440,112,1120,2025-07-24
FC_IL06,SKU001778,267,86,181,56,560,2025-07-26
FC_IL06,SKU000061,651,195,456,112,1120,2025-07-25
FC_IL06,SKU000209,546,166,380,84,840,2025-07-24
FC_IL06,SKU000310,804,267,537,140,1400,2025-07-24
FC_IL06,SKU001015,261,80,181,56,560,2025-07-25
FC_IL06,SKU001793,569,198,371,84,840,2025-07-24
FC_IL06,SKU001744,625,201,424,112,1120,2025-07-26
FC_IL06,SKU000867,578,171,407,84,840,2025-07-25
FC_IL06,SKU000113,517,175,342,84,840,2025-07-23
FC_IL06,SKU000220,877,273,604,140,1400,2025-07-25
FC_IL06,SKU001859,537,172,365,84,840,2025-07-23
FC_IL06,SKU001028,869,238,631,140,1400,2025-07-25
FC_IL06,SKU000603,557,188,369,84,840,2025-07-23
FC_IL06,SKU001944,1573,482,1091,210,2100,2025-07-27
FC_IL06,SKU001045,266,70,196,56,560,2025-07-22
FC_IL06,SKU000392,620,174,446,112,1120,2025-07-23
FC_IL06,SKU001474,1598,493,1105,210,2100,2025-07-22
FC_IL06,SKU001293,268,82,186,56,560,2025-07-22
FC_IL06,SKU000047,1587,515,1072,210,2100,2025-07-23
FC_IL06,SKU000578,864,278,586,140,1400,2025-07-23
FC_IL06,SKU001506,637,213,424,112,1120,2025-07-21
FC_IL06,SKU001137,613,173,440,112,1120,2025-07-24
FC_IL06,SKU001326,261,78,183,56,560,2025-07-23
FC_IL06,SKU001030,607,195,412,112,1120,2025-07-22
FC_IL06,SKU001799,1584,498,1086,210,2100,2025-07-21
FC_IL06,SKU000915,251,66,185,56,560,2025-07-23
FC_IL06,SKU001610,248,86,162,56,560,2025-07-26
FC_IL06,SKU000957,596,179,417,112,1120,2025-07-27
FC_IL06,SKU001361,834,236,598,140,1400,2025-07-27
FC_IL06,SKU001483,1627,471,1156,210,2100,2025-07-23
FC_IL06,SKU000340,656,207,449,112,1120,2025-07-21
FC_IL06,SKU000604,1581,498,1083,210,2100,2025-07-24
FC_IL06,SKU000308,850,222,628,140,1400,2025-07-27
FC_IL06,SKU001971,547,154,393,84,840,2025-07-26
FC_IL06,SKU001174,544,164,380,84,840,2025-07-27
FC_IL06,SKU000749,247,83,164,56,560,2025-07-23
FC_IL06,SKU000535,241,79,162,56,560,2025-07-27
FC_IL06,SKU001935,545,181,364,84,840,2025-07-21
FC_IL06,SKU000620,497,172,325,84,840,2025-07-22
FC_IL06,SKU000235,836,248,588,140,1400,2025-07-23
FC_IL06,SKU000054,1578,443,1135,210,2100,2025-07-23
FC_IL06,SKU001127,618,185,433,112,1120,2025-07-23
FC_IL06,SKU000422,261,71,190,56,560,2025-07-25
FC_IL06,SKU001597,871,263,608,140,1400,2025-07-26
FC_IL06,SKU001497,619,212,407,112,1120,2025-07-27
FC_IL06,SKU000602,271,75,196,56,560,2025-07-23
FC_IL06,SKU000880,523,166,357,84,840,2025-07-26
FC_IL06,SKU000360,243,61,182,56,560,2025-07-26
FC_IL06,SKU000192,1572,460,1112,210,2100,2025-07-25
FC_IL06,SKU001806,855,266,589,140,1400,2025-07-21
FC_IL06,SKU000501,272,79,193,56,560,2025-07-21
FC_IL06,SKU001508,853,289,564,140,1400,2025-07-23
FC_IL06,SKU000970,1540,434,1106,210,2100,2025-07-22
FC_IL06,SKU000040,246,81,165,56,560,2025-07-22
FC_IL06,SKU000705,249,91,158,56,560,2025-07-22
FC_IL06,SKU000223,247,68,179,56,560,2025-07-21
FC_IL06,SKU000123,817,250,567,140,1400,2025-07-21
FC_IL06,SKU000721,616,183,433,112,1120,2025-07-23
FC_IL06,SKU000283,641,156,485,112,1120,2025-07-23
FC_IL06,SKU000533,253,72,181,56,560,2025-07-26
FC_IL06,SKU001622,610,181,429,112,1120,2025-07-21
FC_IL06,SKU001975,823,271,552,140,1400,2025-07-24
FC_IL06,SKU000021,888,268,620,140,1400,2025-07-24
FC_IL06,SKU001018,543,147,396,84,840,2025-07-26
FC_IL06,SKU000793,257,73,184,56,560,2025-07-24
FC_IL06,SKU000566,1517,441,1076,210,2100,2025-07-21
FC_IL06,SKU001839,838,247,591,140,1400,2025-07-27
FC_IL06,SKU000019,1610,501,1109,210,2100,2025-07-24
FC_IL06,SKU000132,241,64,177,56,560,2025-07-21
FC_IL06,SKU000829,897,296,601,140,1400,2025-07-26
FC_IL06,SKU000391,1573,459,1114,210,2100,2025-07-24
FC_IL06,SKU000419,599,147,452,112,1120,2025-07-21
FC_IL06,SKU001846,814,236,578,140,1400,2025-07-21
FC_IL06,SKU000625,1637,456,1181,210,2100,2025-07-23
FC_IL06,SKU000834,653,190,463,112,1120,2025-07-22
FC_IL06,SKU000334,870,277,593,140,1400,2025-07-27
FC_IL06,SKU000431,812,219,593,140,1400,2025-07-22
FC_IL06,SKU000956,830,230,600,140,1400,2025-07-23
FC_IL06,SKU000189,229,84,145,56,560,2025-07-25
FC_IL06,SKU000871,633,168,465,112,1120,2025-07-26
FC_IL06,SKU000743,1577,481,1096,210,2100,2025-07-24
FC_IL06,SKU000415,255,84,171,56,560,2025-07-23
FC_IL06,SKU000106,242,71,171,56,560,2025-07-27
FC_IL06,SKU000071,1546,495,1051,210,2100,2025-07-22
FC_IL06,SKU001824,626,183,443,112,1120,2025-07-26
FC_IL06,SKU001725,503,133,370,84,840,2025-07-27
FC_IL06,SKU001865,822,266,556,140,1400,2025-07-23
FC_IL06,SKU000085,839,252,587,140,1400,2025-07-22
FC_IL06,SKU000968,1505,482,1023,210,2100,2025-07-23
FC_IL06,SKU001916,600,160,440,112,1120,2025-07-27
FC_IL06,SKU000833,575,185,390,112,1120,2025-07-21
FC_IL06,SKU001528,566,175,391,84,840,2025-07-21
FC_IL06,SKU001960,621,189,432,112,1120,2025-07-23
FC_IL06,SKU001760,1576,482,1094,210,2100,2025-07-24
FC_IL06,SKU000787,257,76,181,56,560,2025-07-27
FC_IL06,SKU000975,801,244,557,140,1400,2025-07-23
FC_IL06,SKU001877,857,259,598,140,1400,2025-07-23
FC_IL06,SKU001630,618,206,412,112,1120,2025-07-26
FC_IL06,SKU000889,573,184,389,112,1120,2025-07-26
FC_IL06,SKU001742,562,191,371,84,840,2025-07-23
FC_IL06,SKU001430,1604,478,1126,210,2100,2025-07-25
FC_IL06,SKU000027,594,194,400,112,1120,2025-07-21
FC_IL06,SKU000091,870,279,591,140,1400,2025-07-24
FC_IL06,SKU001040,545,187,358,84,840,2025-07-21
FC_IL06,SKU001013,246,77,169,56,560,2025-07-24
FC_IL06,SKU001791,812,236,576,140,1400,2025-07-27
FC_IL06,SKU001060,1615,439,1176,210,2100,2025-07-26
FC_IL06,SKU000561,254,85,169,56,560,2025-07-21
FC_IL06,SKU000855,608,193,415,112,1120,2025-07-24
FC_IL06,SKU000023,571,164,407,112,1120,2025-07-25
FC_IL06,SKU000375,1566,471,1095,210,2100,2025-07-26
FC_IL06,SKU000768,862,272,590,140,1400,2025-07-22
FC_IL06,SKU001353,847,232,615,140,1400,2025-07-24
FC_IL06,SKU000492,900,259,641,140,1400,2025-07-27
FC_IL06,SKU000339,845,270,575,140,1400,2025-07-22
FC_IL06,SKU000982,245,90,155,56,560,2025-07-27
FC_IL06,SKU001319,252,81,171,56,560,2025-07-22
FC_IL06,SKU000996,846,246,600,140,1400,2025-07-21
FC_IL06,SKU001660,538,177,361,84,840,2025-07-21
FC_IL06,SKU000122,916,272,644,140,1400,2025-07-25
FC_IL06,SKU000195,858,266,592,140,1400,2025-07-24
FC_IL06,SKU001885,615,196,419,112,1120,2025-07-22
FC_IL06,SKU000342,622,181,441,112,1120,2025-07-23
FC_IL06,SKU000820,1593,474,1119,210,2100,2025-07-22
FC_IL06,SKU001493,800,248,552,140,1400,2025-07-23
FC_IL06,SKU000706,248,82,166,56,560,2025-07-21
FC_IL06,SKU001415,258,87,171,56,560,2025-07-26
FC_IL06,SKU000152,230,66,164,56,560,2025-07-27
FC_IL06,SKU000738,246,81,165,56,560,2025-07-25
FC_IL06,SKU001079,263,94,169,56,560,2025-07-27
FC_IL06,SKU000430,852,269,583,140,1400,2025-07-23
FC_IL06,SKU001298,283,58,225,56,560,2025-07-22
FC_IL06,SKU000371,610,154,456,112,1120,2025-07-21
FC_IL06,SKU001988,839,255,584,140,1400,2025-07-21
FC_IL06,SKU001304,242,72,170,56,560,2025-07-21
FC_IL06,SKU001222,262,80,182,56,560,2025-07-27
FC_IL06,SKU000702,251,81,170,56,560,2025-07-27
FC_IL06,SKU000780,619,214,405,112,1120,2025-07-21
FC_IL06,SKU001735,1636,501,1135,210,2100,2025-07-21
FC_IL06,SKU000714,256,84,172,56,560,2025-07-26
FC_IL06,SKU001709,241,73,168,56,560,2025-07-22
FC_IL06,SKU001349,249,69,180,56,560,2025-07-23
FC_IL06,SKU001905,1630,498,1132,210,2100,2025-07-22
FC_IL06,SKU001070,847,260,587,140,1400,2025-07-22
FC_IL06,SKU001548,778,251,527,140,1400,2025-07-27
FC_IL06,SKU000264,818,274,544,140,1400,2025-07-24
FC_IL06,SKU001374,535,137,398,84,840,2025-07-26
FC_IL06,SKU001056,856,272,584,140,1400,2025-07-27
FC_IL06,SKU001516,852,261,591,140,1400,2025-07-23
FC_IL06,SKU001138,1608,497,1111,210,2100,2025-07-21
FC_IL06,SKU000633,235,74,161,56,560,2025-07-22
FC_IL06,SKU001149,573,179,394,84,840,2025-07-24
FC_IL06,SKU000457,820,221,599,140,1400,2025-07-24
FC_IL06,SKU001974,549,162,387,84,840,2025-07-22
FC_IL06,SKU000519,242,83,159,56,560,2025-07-21
FC_IL06,SKU000104,618,188,430,112,1120,2025-07-27
FC_IL06,SKU000894,570,174,396,112,1120,2025-07-27
FC_IL06,SKU000297,601,180,421,112,1120,2025-07-23
FC_IL06,SKU001560,1538,476,1062,210,2100,2025-07-24
FC_IL06,SKU000329,515,156,359,84,840,2025-07-24
FC_IL06,SKU001106,1637,477,1160,210,2100,2025-07-24
FC_IL06,SKU001206,528,179,349,84,840,2025-07-22
FC_IL06,SKU001356,235,68,167,56,560,2025-07-25
FC_IL06,SKU000026,617,194,423,112,1120,2025-07-24
FC_IL06,SKU000108,1514,461,1053,210,2100,2025-07-26
FC_IL06,SKU000470,527,177,350,84,840,2025-07-24
FC_IL06,SKU000858,556,164,392,84,840,2025-07-22
FC_IL06,SKU000068,1533,480,1053,210,2100,2025-07-24
FC_IL06,SKU000502,808,256,552,140,1400,2025-07-24
FC_IL06,SKU000294,812,265,547,140,1400,2025-07-22
FC_IL06,SKU000366,1608,482,1126,210,2100,2025-07-27
FC_IL06,SKU000955,597,186,411,84,840,2025-07-27
FC_IL06,SKU001752,241,81,160,56,560,2025-07-25
FC_IL06,SKU000438,552,151,401,84,840,2025-07-27
FC_IL06,SKU001738,1570,483,1087,210,2100,2025-07-24
FC_IL06,SKU000425,855,266,589,140,1400,2025-07-26
FC_IL06,SKU000312,810,236,574,140,1400,2025-07-27
FC_IL06,SKU001433,245,77,168,56,560,2025-07-21
FC_IL06,SKU001598,245,75,170,56,560,2025-07-22
FC_IL06,SKU001002,806,263,543,140,1400,2025-07-23
FC_IL06,SKU001362,587,197,390,84,840,2025-07-22
FC_IL06,SKU001690,538,171,367,84,840,2025-07-27
FC_IL06,SKU000471,251,80,171,56,560,2025-07-23
FC_IL06,SKU000678,1553,456,1097,210,2100,2025-07-21
FC_IL06,SKU001389,511,119,392,84,840,2025-07-21
FC_IL06,SKU001779,1586,493,1093,210,2100,2025-07-21
FC_IL06,SKU000305,277,84,193,56,560,2025-07-25
FC_IL06,SKU001983,1578,469,1109,210,2100,2025-07-26
FC_IL06,SKU001167,614,196,418,112,1120,2025-07-21
FC_IL06,SKU001612,520,140,380,84,840,2025-07-22
FC_IL06,SKU000638,843,249,594,140,1400,2025-07-21
FC_IL06,SKU001841,595,170,425,84,840,2025-07-24
FC_IL06,SKU001503,847,289,558,140,1400,2025-07-23
FC_IL06,SKU000058,607,184,423,112,1120,2025-07-26
FC_IL06,SKU001637,622,174,448,112,1120,2025-07-23
FC_IL06,SKU000937,237,52,185,56,560,2025-07-23
FC_IL06,SKU001038,1542,481,1061,210,2100,2025-07-24
FC_IL06,SKU000490,571,167,404,112,1120,2025-07-22
FC_IL06,SKU000035,855,281,574,140,1400,2025-07-21
FC_IL06,SKU001051,588,198,390,84,840,2025-07-22
FC_IL06,SKU001011,812,225,587,140,1400,2025-07-24
FC_IL06,SKU001858,1556,444,1112,210,2100,2025-07-22
FC_IL06,SKU000800,531,161,370,84,840,2025-07-25
FC_IL06,SKU001099,1618,474,1144,210,2100,2025-07-21
FC_IL06,SKU000051,593,197,396,112,1120,2025-07-24
FC_IL06,SKU000320,1535,467,1068,210,2100,2025-07-25
FC_IL06,SKU001702,648,179,469,112,1120,2025-07-23
FC_IL06,SKU000344,828,263,565,140,1400,2025-07-22
FC_IL06,SKU000911,245,73,172,56,560,2025-07-21
FC_IL06,SKU000737,1628,474,1154,210,2100,2025-07-25
FC_IL06,SKU001741,800,247,553,140,1400,2025-07-22
FC_IL06,SKU000569,541,163,378,84,840,2025-07-26
FC_IL06,SKU000884,590,208,382,112,1120,2025-07-27
FC_IL06,SKU001537,906,260,646,140,1400,2025-07-24
FC_IL06,SKU001424,1540,476,1064,210,2100,2025-07-24
FC_IL06,SKU001339,831,238,593,140,1400,2025-07-21
FC_IL06,SKU000200,1600,479,1121,210,2100,2025-07-27
FC_IL06,SKU001297,842,250,592,140,1400,2025-07-26
FC_IL06,SKU001024,570,184,386,84,840,2025-07-26
FC_IL06,SKU000564,631,188,443,112,1120,2025-07-26
FC_IL06,SKU001762,254,91,163,56,560,2025-07-27
FC_IL06,SKU000097,239,74,165,56,560,2025-07-26
FC_IL06,SKU000752,858,225,633,140,1400,2025-07-22
FC_IL06,SKU000840,821,260,561,140,1400,2025-07-26
FC_IL06,SKU000240,245,71,174,56,560,2025-07-26
FC_IL06,SKU001577,1506,429,1077,210,2100,2025-07-27
FC_IL06,SKU000164,670,192,478,112,1120,2025-07-26
FC_IL06,SKU001728,591,162,429,84,840,2025-07-23
FC_IL06,SKU000095,546,154,392,84,840,2025-07-27
FC_IL06,SKU000936,1565,483,1082,210,2100,2025-07-26
FC_IL06,SKU001863,568,184,384,84,840,2025-07-22
FC_IL06,SKU001798,245,67,178,56,560,2025-07-21
FC_IL06,SKU001837,604,211,393,112,1120,2025-07-24
FC_IL06,SKU000251,259,83,176,56,560,2025-07-23
FC_IL06,SKU001547,1619,511,1108,210,2100,2025-07-26
FC_IL06,SKU001238,506,173,333,84,840,2025-07-25
FC_IL06,SKU001052,852,262,590,140,1400,2025-07-27
FC_IL06,SKU000537,593,148,445,112,1120,2025-07-22
FC_IL06,SKU001219,580,178,402,112,1120,2025-07-21
FC_IL06,SKU000409,583,170,413,112,1120,2025-07-22
FC_IL06,SKU000024,614,156,458,112,1120,2025-07-24
FC_IL06,SKU001951,1608,506,1102,210,2100,2025-07-21
FC_IL06,SKU000565,837,261,576,140,1400,2025-07-21
FC_IL06,SKU000680,1570,472,1098,210,2100,2025-07-21
FC_IL06,SKU000488,545,139,406,84,840,2025-07-27
FC_IL06,SKU001953,1586,443,1143,210,2100,2025-07-22
FC_IL06,SKU000052,271,79,192,56,560,2025-07-25
FC_IL06,SKU000148,1561,454,1107,210,2100,2025-07-23
FC_IL06,SKU001749,261,80,181,56,560,2025-07-23
FC_IL06,SKU001073,586,176,410,112,1120,2025-07-21
FC_IL06,SKU000102,259,75,184,56,560,2025-07-25
FC_IL06,SKU001470,822,227,595,140,1400,2025-07-25
FC_IL06,SKU000661,266,83,183,56,560,2025-07-22
FC_IL06,SKU000807,249,77,172,56,560,2025-07-22
FC_IL06,SKU001412,592,183,409,84,840,2025-07-26
FC_IL06,SKU000773,514,131,383,84,840,2025-07-26
FC_IL06,SKU000441,264,75,189,56,560,2025-07-27
FC_IL06,SKU000724,556,150,406,84,840,2025-07-22
FC_IL06,SKU001989,1611,485,1126,210,2100,2025-07-24
FC_IL06,SKU001724,1590,494,1096,210,2100,2025-07-22
FC_IL06,SKU000733,533,154,379,84,840,2025-07-24
FC_IL06,SKU001441,574,159,415,84,840,2025-07-22
FC_IL06,SKU001589,1594,473,1121,210,2100,2025-07-27
FC_IL06,SKU000540,843,225,618,140,1400,2025-07-27
FC_IL06,SKU001699,237,69,168,56,560,2025-07-21
FC_IL06,SKU001671,643,191,452,112,1120,2025-07-21
FC_IL06,SKU000943,574,167,407,84,840,2025-07-24
FC_IL06,SKU001881,238,66,172,56,560,2025-07-26
FC_IL06,SKU001331,1585,448,1137,210,2100,2025-07-21
FC_IL06,SKU001459,638,195,443,112,1120,2025-07-25
FC_IL06,SKU000288,512,148,364,84,840,2025-07-24
FC_IL06,SKU000337,240,80,160,56,560,2025-07-26
FC_IL06,SKU000595,1541,474,1067,210,2100,2025-07-27
FC_IL06,SKU001108,240,78,162,56,560,2025-07-21
FC_IL06,SKU001031,259,94,165,56,560,2025-07-25
FC_IL06,SKU000053,580,183,397,84,840,2025-07-21
FC_IL06,SKU001961,573,179,394,84,840,2025-07-27
FC_IL06,SKU001282,862,258,604,140,1400,2025-07-24
FC_IL06,SKU000353,1585,498,1087,210,2100,2025-07-25
FC_IL06,SKU000436,822,224,598,140,1400,2025-07-22
FC_IL06,SKU000130,256,81,175,56,560,2025-07-26
FC_IL06,SKU000500,263,81,182,56,560,2025-07-21
FC_IL06,SKU001103,594,158,436,112,1120,2025-07-24
FC_IL06,SKU001254,1578,468,1110,210,2100,2025-07-22
FC_IL06,SKU001867,607,175,432,112,1120,2025-07-21
FC_IL06,SKU001888,848,266,582,140,1400,2025-07-24
FC_IL06,SKU000650,827,241,586,140,1400,2025-07-26
FC_IL06,SKU000779,1516,428,1088,210,2100,2025-07-23
FC_IL06,SKU001406,618,177,441,112,1120,2025-07-21
FC_IL06,SKU000157,562,176,386,84,840,2025-07-27
FC_IL06,SKU001946,900,267,633,140,1400,2025-07-26
FC_IL06,SKU000469,1549,480,1069,210,2100,2025-07-27
FC_IL06,SKU001261,242,89,153,56,560,2025-07-27
FC_IL06,SKU001173,564,182,382,84,840,2025-07-26
FC_IL06,SKU000865,1601,501,1100,210,2100,2025-07-25
FC_IL06,SKU001377,1493,455,1038,210,2100,2025-07-22
FC_IL06,SKU000210,571,169,402,84,840,2025-07-25
FC_IL06,SKU000760,857,252,605,140,1400,2025-07-23
FC_IL06,SKU001770,1560,461,1099,210,2100,2025-07-22
FC_IL06,SKU000117,798,236,562,140,1400,2025-07-23
FC_IL06,SKU001657,1642,477,1165,210,2100,2025-07-27
FC_IL06,SKU000944,273,74,199,56,560,2025-07-24
FC_IL06,SKU000653,235,74,161,56,560,2025-07-24
FC_IL06,SKU000090,1621,484,1137,210,2100,2025-07-22
FC_IL06,SKU000228,566,169,397,112,1120,2025-07-23
FC_IL06,SKU000140,275,64,211,56,560,2025-07-23
FC_IL06,SKU001047,857,262,595,140,1400,2025-07-23
FC_IL06,SKU001831,856,271,585,140,1400,2025-07-24
FC_IL06,SKU001448,269,74,195,56,560,2025-07-27
FC_IL06,SKU000524,853,260,593,140,1400,2025-07-21
FC_IL06,SKU000766,221,61,160,56,560,2025-07-23
FC_IL06,SKU001882,530,148,382,84,840,2025-07-21
FC_IL06,SKU000756,555,161,394,84,840,2025-07-21
FC_IL06,SKU001191,564,192,372,84,840,2025-07-23
FC_IL06,SKU001857,249,80,169,56,560,2025-07-26
FC_IL06,SKU000796,232,69,163,56,560,2025-07-26
FC_IL06,SKU000281,1515,418,1097,210,2100,2025-07-21
FC_IL06,SKU001096,849,269,580,140,1400,2025-07-21
FC_IL06,SKU000347,523,163,360,84,840,2025-07-22
FC_IL06,SKU000265,878,286,592,140,1400,2025-07-23
FC_IL06,SKU000259,1547,487,1060,210,2100,2025-07-23
FC_IL06,SKU000295,871,273,598,140,1400,2025-07-24
FC_IL06,SKU001434,254,75,179,56,560,2025-07-27
FC_IL06,SKU001107,620,189,431,112,1120,2025-07-22
FC_IL06,SKU000348,598,169,429,112,1120,2025-07-23
FC_IL06,SKU000154,586,160,426,112,1120,2025-07-25
FC_IL06,SKU001782,825,221,604,140,1400,2025-07-21
FC_IL06,SKU001569,621,200,421,112,1120,2025-07-26
FC_IL06,SKU000491,536,150,386,84,840,2025-07-23
FC_IL06,SKU000404,631,186,445,112,1120,2025-07-26
FC_IL06,SKU001458,284,85,199,56,560,2025-07-24
FC_IL06,SKU000014,787,238,549,140,1400,2025-07-22
FC_IL06,SKU000003,616,174,442,112,1120,2025-07-25
FC_IL06,SKU001290,257,84,173,56,560,2025-07-26
FC_IL06,SKU000165,248,94,154,56,560,2025-07-21
FC_IL06,SKU000399,596,153,443,112,1120,2025-07-27
FC_IL06,SKU000181,836,246,590,140,1400,2025-07-27
FC_IL06,SKU000278,838,234,604,140,1400,2025-07-23
FC_IL06,SKU000362,617,188,429,112,1120,2025-07-23
FC_IL06,SKU001763,861,257,604,140,1400,2025-07-27
FC_IL06,SKU001734,566,150,416,112,1120,2025-07-25
FC_IL06,SKU001161,598,183,415,112,1120,2025-07-21
FC_IL06,SKU001245,608,213,395,112,1120,2025-07-24
FC_IL06,SKU001368,574,177,397,112,1120,2025-07-22
FC_IL06,SKU001023,834,251,583,140,1400,2025-07-25
FC_IL06,SKU000930,1552,476,1076,210,2100,2025-07-22
FC_IL06,SKU001852,874,251,623,140,1400,2025-07-24
FC_IL06,SKU000513,790,258,532,140,1400,2025-07-23
FC_IL06,SKU001759,621,204,417,112,1120,2025-07-25
FC_IL06,SKU001801,862,223,639,140,1400,2025-07-24
FC_IL06,SKU001034,845,226,619,140,1400,2025-07-23
FC_IL06,SKU001009,1638,490,1148,210,2100,2025-07-24
FC_IL06,SKU000557,544,158,386,84,840,2025-07-22
FC_IL06,SKU000088,821,248,573,140,1400,2025-07-27
FC_IL06,SKU000806,616,162,454,84,840,2025-07-27
FC_IL06,SKU000233,639,180,459,112,1120,2025-07-22
FC_IL06,SKU000725,620,173,447,112,1120,2025-07-24
FC_IL06,SKU001350,529,143,386,84,840,2025-07-25
FC_IL06,SKU001676,1563,498,1065,210,2100,2025-07-24
FC_IL06,SKU000177,617,190,427,112,1120,2025-07-26
FC_IL06,SKU000250,657,188,469,112,1120,2025-07-24
FC_IL06,SKU000901,590,205,385,112,1120,2025-07-26
FC_IL06,SKU001198,845,252,593,140,1400,2025-07-24
FC_IL06,SKU001487,535,183,352,84,840,2025-07-23
FC_IL06,SKU000879,517,144,373,84,840,2025-07-23
FC_IL06,SKU000636,811,229,582,140,1400,2025-07-23
FC_IL06,SKU000016,619,198,421,112,1120,2025-07-21
FC_IL06,SKU001022,1553,455,1098,210,2100,2025-07-24
FC_IL06,SKU001124,613,181,432,112,1120,2025-07-21
FC_IL06,SKU001549,598,179,419,112,1120,2025-07-23
FC_IL06,SKU001556,567,180,387,84,840,2025-07-21
FC_IL06,SKU001417,1564,490,1074,210,2100,2025-07-25
FC_IL06,SKU000536,1649,471,1178,210,2100,2025-07-27
FC_IL06,SKU001542,811,236,575,140,1400,2025-07-21
FC_IL06,SKU001840,564,167,397,84,840,2025-07-27
FC_IL06,SKU000801,254,71,183,56,560,2025-07-22
FC_IL06,SKU000155,1560,477,1083,210,2100,2025-07-25
FC_IL06,SKU000486,1584,449,1135,210,2100,2025-07-27
FC_IL06,SKU000450,616,155,461,112,1120,2025-07-25
FC_IL06,SKU000128,613,183,430,112,1120,2025-07-23
FC_IL06,SKU000994,241,85,156,56,560,2025-07-25
FC_IL06,SKU001862,230,81,149,56,560,2025-07-21
FC_IL06,SKU001810,627,179,448,112,1120,2025-07-26
FC_IL06,SKU001574,243,79,164,56,560,2025-07-22
FC_IL06,SKU000247,858,267,591,140,1400,2025-07-22
FC_IL06,SKU001687,258,63,195,56,560,2025-07-25
FC_IL06,SKU001150,1534,448,1086,210,2100,2025-07-27
FC_IL06,SKU000424,590,154,436,112,1120,2025-07-21
FC_IL06,SKU001048,249,83,166,56,560,2025-07-24
FC_IL06,SKU001696,240,81,159,56,560,2025-07-21
FC_IL06,SKU000378,841,276,565,140,1400,2025-07-27
FC_IL06,SKU000463,250,79,171,56,560,2025-07-24
FC_IL06,SKU001317,1484,470,1014,210,2100,2025-07-23
FC_IL06,SKU001499,1632,502,1130,210,2100,2025-07-26
FC_IL06,SKU001641,519,126,393,84,840,2025-07-23
FC_IL06,SKU000811,562,161,401,84,840,2025-07-23
FC_IL06,SKU000008,1617,498,1119,210,2100,2025-07-23
FC_IL06,SKU001075,600,183,417,112,1120,2025-07-21
FC_IL06,SKU000748,606,186,420,112,1120,2025-07-23
FC_IL06,SKU000044,242,71,171,56,560,2025-07-23
FC_IL06,SKU001095,860,252,608,140,1400,2025-07-27
FC_IL06,SKU001332,254,76,178,56,560,2025-07-25
FC_IL06,SKU001280,1568,486,1082,210,2100,2025-07-25
FC_IL06,SKU000522,551,172,379,84,840,2025-07-25
FC_IL06,SKU000847,251,81,170,56,560,2025-07-25
FC_IL06,SKU001518,847,241,606,140,1400,2025-07-27
FC_IL06,SKU000763,849,247,602,140,1400,2025-07-25
FC_IL06,SKU001367,601,196,405,84,840,2025-07-21
FC_IL06,SKU000808,1517,462,1055,210,2100,2025-07-22
FC_IL06,SKU001557,633,228,405,112,1120,2025-07-22
FC_IL06,SKU001844,582,171,411,112,1120,2025-07-21
FC_IL06,SKU001963,560,171,389,84,840,2025-07-27
FC_IL06,SKU001285,250,79,171,56,560,2025-07-21
FC_IL06,SKU000229,245,85,160,56,560,2025-07-25
FC_IL06,SKU000218,1610,508,1102,210,2100,2025-07-23
FC_IL06,SKU000368,652,178,474,112,1120,2025-07-27
FC_IL06,SKU000160,259,82,177,56,560,2025-07-24
FC_IL06,SKU001268,277,80,197,56,560,2025-07-27
FC_IL06,SKU001532,541,180,361,84,840,2025-07-27
FC_IL06,SKU000624,822,257,565,140,1400,2025-07-22
FC_IL06,SKU000029,1520,453,1067,210,2100,2025-07-26
FC_IL06,SKU001348,833,247,586,140,1400,2025-07-25
FC_IL06,SKU001876,524,141,383,84,840,2025-07-21
FC_IL06,SKU000448,583,156,427,112,1120,2025-07-23
FC_IL06,SKU000515,1528,425,1103,210,2100,2025-07-23
FC_IL06,SKU001185,565,196,369,112,1120,2025-07-24
FC_IL06,SKU001123,244,78,166,56,560,2025-07-25
FC_IL06,SKU001934,1544,471,1073,210,2100,2025-07-24
FC_IL06,SKU000684,847,239,608,140,1400,2025-07-21
FC_IL06,SKU001498,621,139,482,112,1120,2025-07-27
FC_IL06,SKU000221,1618,457,1161,210,2100,2025-07-23
FC_IL06,SKU001196,805,250,555,140,1400,2025-07-25
FC_IL06,SKU000232,597,172,425,112,1120,2025-07-22
FC_IL06,SKU000544,586,180,406,112,1120,2025-07-24
FC_IL06,SKU001207,811,208,603,140,1400,2025-07-26
FC_IL06,SKU001968,549,168,381,84,840,2025-07-22
FC_IL06,SKU001102,277,72,205,56,560,2025-07-23
FC_IL06,SKU001611,854,246,608,140,1400,2025-07-21
FC_IL06,SKU000814,1589,433,1156,210,2100,2025-07-22
FC_IL06,SKU001294,620,162,458,112,1120,2025-07-24
FC_IL06,SKU000112,1540,460,1080,210,2100,2025-07-21
FC_IL06,SKU001691,854,261,593,140,1400,2025-07-26
FC_IL06,SKU000675,1517,425,1092,210,2100,2025-07-27
FC_IL06,SKU001655,635,194,441,112,1120,2025-07-23
FC_IL06,SKU000126,1525,435,1090,210,2100,2025-07-24
FC_IL06,SKU001943,1597,472,1125,210,2100,2025-07-21
FC_IL06,SKU001965,1598,494,1104,210,2100,2025-07-21
FC_IL06,SKU000215,817,245,572,140,1400,2025-07-26
FC_IL06,SKU000634,1680,491,1189,210,2100,2025-07-26
FC_IL06,SKU001739,592,172,420,112,1120,2025-07-21
FC_IL06,SKU001808,611,183,428,112,1120,2025-07-26
FC_IL06,SKU001871,823,244,579,140,1400,2025-07-21
FC_IL06,SKU000135,555,185,370,84,840,2025-07-22
FC_IL06,SKU000771,1635,451,1184,210,2100,2025-07-21
FC_IL06,SKU000006,850,257,593,140,1400,2025-07-27
FC_IL06,SKU000822,262,73,189,56,560,2025-07-23
FC_IL06,SKU001621,253,80,173,56,560,2025-07-22
FC_IL06,SKU001411,1502,472,1030,210,2100,2025-07-26
FC_IL06,SKU000361,580,165,415,112,1120,2025-07-23
FC_IL06,SKU000546,244,78,166,56,560,2025-07-24
FC_IL06,SKU000848,828,272,556,140,1400,2025-07-27
FC_IL06,SKU001478,841,247,594,140,1400,2025-07-26
FC_IL06,SKU000864,535,171,364,84,840,2025-07-23
FC_IL06,SKU001689,896,249,647,140,1400,2025-07-23
FC_IL06,SKU001043,269,90,179,56,560,2025-07-22
FC_IL06,SKU001566,1556,489,1067,210,2100,2025-07-25
FC_IL06,SKU001866,1592,475,1117,210,2100,2025-07-25
FC_IL06,SKU001094,594,154,440,112,1120,2025-07-23
FC_IL06,SKU000033,1586,509,1077,210,2100,2025-07-23
FC_IL06,SKU001625,880,280,600,140,1400,2025-07-26
FC_IL06,SKU000296,254,78,176,56,560,2025-07-24
FC_IL06,SKU001632,519,161,358,84,840,2025-07-23
FC_IL06,SKU000837,864,270,594,140,1400,2025-07-22
FC_IL06,SKU000461,628,184,444,112,1120,2025-07-26
FC_IL06,SKU000972,534,148,386,84,840,2025-07-24
FC_IL06,SKU001273,558,175,383,84,840,2025-07-22
FC_IL06,SKU000326,240,80,160,56,560,2025-07-27
FC_IL06,SKU001761,590,159,431,112,1120,2025-07-25
FC_IL06,SKU000395,856,249,607,140,1400,2025-07-22
FC_IL06,SKU000601,839,285,554,140,1400,2025-07-23
FC_IL06,SKU000343,1630,494,1136,210,2100,2025-07-22
FC_IL06,SKU000260,847,266,581,140,1400,2025-07-24
FC_IL06,SKU000013,649,213,436,112,1120,2025-07-21
FC_IL06,SKU000036,870,265,605,140,1400,2025-07-21
FC_IL06,SKU000120,608,192,416,112,1120,2025-07-21
FC_IL06,SKU000330,1605,541,1064,210,2100,2025-07-22
FC_IL06,SKU000022,810,231,579,140,1400,2025-07-24
FC_IL06,SKU001394,1625,479,1146,210,2100,2025-07-27
FC_IL06,SKU000846,832,240,592,140,1400,2025-07-23
FC_IL06,SKU001358,1588,488,1100,210,2100,2025-07-26
FC_IL06,SKU000984,680,188,492,112,1120,2025-07-25
FC_IL06,SKU001212,813,245,568,140,1400,2025-07-27
FC_IL06,SKU000093,869,244,625,140,1400,2025-07-22
FC_IL06,SKU000642,535,170,365,84,840,2025-07-27
FC_IL06,SKU001464,1521,458,1063,210,2100,2025-07-23
FC_IL06,SKU000832,495,131,364,84,840,2025-07-25
FC_IL06,SKU000657,591,165,426,112,1120,2025-07-21
FC_IL06,SKU001826,636,180,456,112,1120,2025-07-21
FC_IL06,SKU000173,1580,494,1086,210,2100,2025-07-23
FC_IL06,SKU001151,595,171,424,112,1120,2025-07-22
FC_IL06,SKU001153,566,163,403,84,840,2025-07-27
FC_IL06,SKU001833,614,183,431,112,1120,2025-07-26
FC_FL07,SKU000598,541,137,404,84,840,2025-07-24
FC_FL07,SKU001974,560,161,399,84,840,2025-07-21
FC_FL07,SKU001140,871,251,620,140,1400,2025-07-27
FC_FL07,SKU001471,859,258,601,140,1400,2025-07-26
FC_FL07,SKU000145,1583,486,1097,210,2100,2025-07-25
FC_FL07,SKU000748,635,142,493,112,1120,2025-07-26
FC_FL07,SKU001222,247,71,176,56,560,2025-07-27
FC_FL07,SKU000707,290,92,198,56,560,2025-07-24
FC_FL07,SKU000515,1615,486,1129,210,2100,2025-07-22
FC_FL07,SKU001178,1602,484,1118,210,2100,2025-07-23
FC_FL07,SKU001297,822,224,598,140,1400,2025-07-25
FC_FL07,SKU000883,877,271,606,140,1400,2025-07-21
FC_FL07,SKU001729,273,73,200,56,560,2025-07-27
FC_FL07,SKU001889,1583,456,1127,210,2100,2025-07-21
FC_FL07,SKU000017,527,147,380,84,840,2025-07-22
FC_FL07,SKU001132,624,168,456,112,1120,2025-07-26
FC_FL07,SKU001580,487,161,326,84,840,2025-07-24
FC_FL07,SKU000039,637,215,422,112,1120,2025-07-23
FC_FL07,SKU000844,843,242,601,140,1400,2025-07-22
FC_FL07,SKU000191,1520,443,1077,210,2100,2025-07-24
FC_FL07,SKU000380,600,202,398,112,1120,2025-07-22
FC_FL07,SKU001207,831,233,598,140,1400,2025-07-27
FC_FL07,SKU001176,1589,450,1139,210,2100,2025-07-27
FC_FL07,SKU000594,1590,508,1082,210,2100,2025-07-24
FC_FL07,SKU001552,530,176,354,84,840,2025-07-21
FC_FL07,SKU000917,514,141,373,84,840,2025-07-25
FC_FL07,SKU000387,1549,451,1098,210,2100,2025-07-23
FC_FL07,SKU001230,597,165,432,112,1120,2025-07-24
FC_FL07,SKU001444,240,75,165,56,560,2025-07-24
FC_FL07,SKU000946,256,89,167,56,560,2025-07-26
FC_FL07,SKU000303,260,78,182,56,560,2025-07-26
FC_FL07,SKU000226,280,90,190,56,560,2025-07-23
FC_FL07,SKU000141,1639,506,1133,210,2100,2025-07-26
FC_FL07,SKU001309,237,55,182,56,560,2025-07-26
FC_FL07,SKU001876,553,160,393,84,840,2025-07-23
FC_FL07,SKU001772,513,163,350,84,840,2025-07-22
FC_FL07,SKU000732,805,263,542,140,1400,2025-07-21
FC_FL07,SKU000244,1550,461,1089,210,2100,2025-07-25
FC_FL07,SKU001879,802,230,572,140,1400,2025-07-25
FC_FL07,SKU001919,754,213,541,140,1400,2025-07-21
FC_FL07,SKU001143,279,96,183,56,560,2025-07-25
FC_FL07,SKU001565,572,170,402,84,840,2025-07-26
FC_FL07,SKU000399,596,177,419,112,1120,2025-07-21
FC_FL07,SKU001854,239,69,170,56,560,2025-07-24
FC_FL07,SKU000781,1568,473,1095,210,2100,2025-07-25
FC_FL07,SKU000730,535,166,369,84,840,2025-07-23
FC_FL07,SKU000102,260,80,180,56,560,2025-07-23
FC_FL07,SKU000656,1550,450,1100,210,2100,2025-07-21
FC_FL07,SKU001374,517,147,370,84,840,2025-07-24
FC_FL07,SKU001597,828,221,607,140,1400,2025-07-23
FC_FL07,SKU001815,786,227,559,140,1400,2025-07-24
FC_FL07,SKU000963,797,249,548,140,1400,2025-07-24
FC_FL07,SKU000799,620,176,444,112,1120,2025-07-27
FC_FL07,SKU000738,242,76,166,56,560,2025-07-22
FC_FL07,SKU001633,540,162,378,84,840,2025-07-25
FC_FL07,SKU000121,510,150,360,84,840,2025-07-27
FC_FL07,SKU000135,528,151,377,84,840,2025-07-27
FC_FL07,SKU001248,668,225,443,112,1120,2025-07-27
FC_FL07,SKU000053,531,158,373,84,840,2025-07-22
FC_FL07,SKU000733,554,168,386,84,840,2025-07-25
FC_FL07,SKU001766,536,146,390,84,840,2025-07-27
FC_FL07,SKU000599,246,66,180,56,560,2025-07-26
FC_FL07,SKU001203,595,177,418,112,1120,2025-07-24
FC_FL07,SKU000618,557,145,412,84,840,2025-07-24
FC_FL07,SKU001145,557,157,400,84,840,2025-07-23
FC_FL07,SKU001724,1635,517,1118,210,2100,2025-07-23
FC_FL07,SKU000064,596,199,397,112,1120,2025-07-26
FC_FL07,SKU001713,644,186,458,112,1120,2025-07-23
FC_FL07,SKU001637,592,175,417,112,1120,2025-07-22
FC_FL07,SKU001735,1580,464,1116,210,2100,2025-07-24
FC_FL07,SKU001667,630,210,420,112,1120,2025-07-21
FC_FL07,SKU000027,579,172,407,112,1120,2025-07-22
FC_FL07,SKU000378,899,267,632,140,1400,2025-07-21
FC_FL07,SKU001369,837,270,567,140,1400,2025-07-23
FC_FL07,SKU000467,241,77,164,56,560,2025-07-21
FC_FL07,SKU001393,275,71,204,56,560,2025-07-21
FC_FL07,SKU001510,247,81,166,56,560,2025-07-27
FC_FL07,SKU001617,549,163,386,84,840,2025-07-22
FC_FL07,SKU001832,628,182,446,112,1120,2025-07-21
FC_FL07,SKU000237,1647,508,1139,210,2100,2025-07-23
FC_FL07,SKU000352,547,165,382,84,840,2025-07-22
FC_FL07,SKU001883,1552,456,1096,210,2100,2025-07-21
FC_FL07,SKU001531,537,165,372,84,840,2025-07-22
FC_FL07,SKU000214,589,183,406,112,1120,2025-07-24
FC_FL07,SKU000566,1590,487,1103,210,2100,2025-07-21
FC_FL07,SKU000301,549,150,399,112,1120,2025-07-26
FC_FL07,SKU000554,599,174,425,112,1120,2025-07-25
FC_FL07,SKU001460,249,70,179,56,560,2025-07-25
FC_FL07,SKU000923,263,78,185,56,560,2025-07-27
FC_FL07,SKU000002,581,174,407,84,840,2025-07-26
FC_FL07,SKU001158,609,155,454,112,1120,2025-07-27
FC_FL07,SKU001748,522,159,363,84,840,2025-07-26
FC_FL07,SKU001153,580,189,391,84,840,2025-07-23
FC_FL07,SKU001868,523,155,368,84,840,2025-07-21
FC_FL07,SKU000742,257,71,186,56,560,2025-07-26
FC_FL07,SKU001135,877,246,631,140,1400,2025-07-23
FC_FL07,SKU000048,242,77,165,56,560,2025-07-24
FC_FL07,SKU001339,830,242,588,140,1400,2025-07-27
FC_FL07,SKU000433,278,73,205,56,560,2025-07-24
FC_FL07,SKU001788,262,86,176,56,560,2025-07-24
FC_FL07,SKU001890,566,177,389,112,1120,2025-07-23
FC_FL07,SKU001882,536,147,389,84,840,2025-07-21
FC_FL07,SKU000908,514,142,372,84,840,2025-07-25
FC_FL07,SKU000192,1555,430,1125,210,2100,2025-07-23
FC_FL07,SKU000271,598,173,425,112,1120,2025-07-24
FC_FL07,SKU001715,827,263,564,140,1400,2025-07-24
FC_FL07,SKU000899,573,180,393,84,840,2025-07-26
FC_FL07,SKU000677,273,72,201,56,560,2025-07-25
FC_FL07,SKU001372,572,202,370,84,840,2025-07-25
FC_FL07,SKU000041,641,192,449,112,1120,2025-07-21
FC_FL07,SKU001809,561,179,382,84,840,2025-07-27
FC_FL07,SKU000235,834,266,568,140,1400,2025-07-22
FC_FL07,SKU001928,604,179,425,112,1120,2025-07-23
FC_FL07,SKU000217,246,84,162,56,560,2025-07-27
FC_FL07,SKU000763,880,278,602,140,1400,2025-07-22
FC_FL07,SKU001949,1541,480,1061,210,2100,2025-07-27
FC_FL07,SKU001786,241,74,167,56,560,2025-07-27
FC_FL07,SKU000919,815,241,574,140,1400,2025-07-27
FC_FL07,SKU001024,519,165,354,84,840,2025-07-22
FC_FL07,SKU000591,258,85,173,56,560,2025-07-25
FC_FL07,SKU001183,597,178,419,84,840,2025-07-21
FC_FL07,SKU000236,823,263,560,140,1400,2025-07-23
FC_FL07,SKU000457,861,239,622,140,1400,2025-07-26
FC_FL07,SKU000258,1554,506,1048,210,2100,2025-07-22
FC_FL07,SKU001727,906,276,630,140,1400,2025-07-24
FC_FL07,SKU000568,254,72,182,56,560,2025-07-27
FC_FL07,SKU001586,1628,481,1147,210,2100,2025-07-27
FC_FL07,SKU000140,257,70,187,56,560,2025-07-21
FC_FL07,SKU000788,1580,466,1114,210,2100,2025-07-26
FC_FL07,SKU001368,619,213,406,112,1120,2025-07-23
FC_FL07,SKU001241,614,203,411,112,1120,2025-07-22
FC_FL07,SKU000757,293,81,212,56,560,2025-07-26
FC_FL07,SKU001321,835,231,604,140,1400,2025-07-22
FC_FL07,SKU001767,235,69,166,56,560,2025-07-24
FC_FL07,SKU000199,593,180,413,112,1120,2025-07-25
FC_FL07,SKU000952,552,158,394,84,840,2025-07-23
FC_FL07,SKU000745,599,178,421,112,1120,2025-07-25
FC_FL07,SKU000374,599,162,437,112,1120,2025-07-25
FC_FL07,SKU000561,263,79,184,56,560,2025-07-24
FC_FL07,SKU001371,569,151,418,84,840,2025-07-22
FC_FL07,SKU001205,1654,509,1145,210,2100,2025-07-27
FC_FL07,SKU000929,1643,532,1111,210,2100,2025-07-24
FC_FL07,SKU000062,236,66,170,56,560,2025-07-26
FC_FL07,SKU000825,250,87,163,56,560,2025-07-27
FC_FL07,SKU001500,627,172,455,112,1120,2025-07-26
FC_FL07,SKU001142,1542,446,1096,210,2100,2025-07-23
FC_FL07,SKU000092,873,248,625,140,1400,2025-07-27
FC_FL07,SKU001487,558,172,386,84,840,2025-07-26
FC_FL07,SKU000785,592,171,421,84,840,2025-07-23
FC_FL07,SKU000798,541,136,405,84,840,2025-07-21
FC_FL07,SKU000731,570,182,388,84,840,2025-07-23
FC_FL07,SKU001447,841,247,594,140,1400,2025-07-23
FC_FL07,SKU000751,605,174,431,112,1120,2025-07-23
FC_FL07,SKU001554,849,235,614,140,1400,2025-07-27
FC_FL07,SKU001599,618,207,411,112,1120,2025-07-23
FC_FL07,SKU000968,1556,476,1080,210,2100,2025-07-22
FC_FL07,SKU001978,918,261,657,140,1400,2025-07-22
FC_FL07,SKU000803,600,181,419,112,1120,2025-07-26
FC_FL07,SKU001147,581,168,413,112,1120,2025-07-21
FC_FL07,SKU000801,221,65,156,56,560,2025-07-24
FC_FL07,SKU001896,513,175,338,84,840,2025-07-24
FC_FL07,SKU001355,236,79,157,56,560,2025-07-23
FC_FL07,SKU001696,231,73,158,56,560,2025-07-22
FC_FL07,SKU001422,591,176,415,112,1120,2025-07-26
FC_FL07,SKU001642,839,258,581,140,1400,2025-07-24
FC_FL07,SKU001726,1560,429,1131,210,2100,2025-07-21
FC_FL07,SKU001701,804,212,592,140,1400,2025-07-22
FC_FL07,SKU001969,635,194,441,112,1120,2025-07-25
FC_FL07,SKU001036,1550,488,1062,210,2100,2025-07-25
FC_FL07,SKU000633,243,75,168,56,560,2025-07-25
FC_FL07,SKU001506,628,209,419,112,1120,2025-07-27
FC_FL07,SKU001270,1577,489,1088,210,2100,2025-07-24
FC_FL07,SKU001697,834,281,553,140,1400,2025-07-23
FC_FL07,SKU001463,629,210,419,112,1120,2025-07-24
FC_FL07,SKU000881,817,254,563,140,1400,2025-07-25
FC_FL07,SKU000772,248,76,172,56,560,2025-07-27
FC_FL07,SKU000519,227,66,161,56,560,2025-07-21
FC_FL07,SKU000789,629,165,464,112,1120,2025-07-23
FC_FL07,SKU000557,499,149,350,84,840,2025-07-23
FC_FL07,SKU001504,236,65,171,56,560,2025-07-24
FC_FL07,SKU000665,546,143,403,84,840,2025-07-22
FC_FL07,SKU000583,611,184,427,112,1120,2025-07-21
FC_FL07,SKU000612,560,159,401,84,840,2025-07-27
FC_FL07,SKU001817,603,184,419,84,840,2025-07-22
FC_FL07,SKU001997,540,181,359,84,840,2025-07-27
FC_FL07,SKU001948,641,178,463,112,1120,2025-07-25
FC_FL07,SKU000007,596,188,408,112,1120,2025-07-24
FC_FL07,SKU001862,228,69,159,56,560,2025-07-27
FC_FL07,SKU000051,573,171,402,112,1120,2025-07-21
FC_FL07,SKU001382,264,86,178,56,560,2025-07-24
FC_FL07,SKU000234,535,167,368,84,840,2025-07-22
FC_FL07,SKU001699,238,53,185,56,560,2025-07-24
FC_FL07,SKU000841,250,77,173,56,560,2025-07-23
FC_FL07,SKU000760,858,249,609,140,1400,2025-07-27
FC_FL07,SKU001015,268,74,194,56,560,2025-07-27
FC_FL07,SKU001847,550,147,403,84,840,2025-07-23
FC_FL07,SKU001898,564,176,388,84,840,2025-07-26
FC_FL07,SKU001017,797,218,579,140,1400,2025-07-23
FC_FL07,SKU000581,250,74,176,56,560,2025-07-26
FC_FL07,SKU001118,491,131,360,84,840,2025-07-24
FC_FL07,SKU000131,251,87,164,56,560,2025-07-21
FC_FL07,SKU000075,1527,412,1115,210,2100,2025-07-27
FC_FL07,SKU000614,552,172,380,112,1120,2025-07-24
FC_FL07,SKU001050,648,207,441,112,1120,2025-07-24
FC_FL07,SKU001045,278,76,202,56,560,2025-07-27
FC_FL07,SKU001224,550,182,368,84,840,2025-07-22
FC_FL07,SKU000111,261,79,182,56,560,2025-07-27
FC_FL07,SKU000435,1517,441,1076,210,2100,2025-07-21
FC_FL07,SKU001643,527,157,370,84,840,2025-07-23
FC_FL07,SKU000690,652,200,452,112,1120,2025-07-22
FC_FL07,SKU000826,885,260,625,140,1400,2025-07-24
FC_FL07,SKU001012,248,85,163,56,560,2025-07-21
FC_FL07,SKU000361,572,174,398,112,1120,2025-07-25
FC_FL07,SKU000854,1491,419,1072,210,2100,2025-07-22
FC_FL07,SKU000790,245,77,168,56,560,2025-07-21
FC_FL07,SKU000814,1530,464,1066,210,2100,2025-07-24
FC_FL07,SKU000280,535,176,359,84,840,2025-07-25
FC_FL07,SKU000058,629,183,446,112,1120,2025-07-22
FC_FL07,SKU001031,281,88,193,56,560,2025-07-23
FC_FL07,SKU000776,833,229,604,140,1400,2025-07-23
FC_FL07,SKU001976,270,64,206,56,560,2025-07-25
FC_FL07,SKU000319,268,98,170,56,560,2025-07-24
FC_FL07,SKU000601,824,244,580,140,1400,2025-07-26
FC_FL07,SKU000863,553,185,368,84,840,2025-07-23
FC_FL07,SKU000465,856,249,607,140,1400,2025-07-24
FC_FL07,SKU000011,538,160,378,84,840,2025-07-26
FC_FL07,SKU000215,832,256,576,140,1400,2025-07-21
FC_FL07,SKU000127,652,213,439,112,1120,2025-07-23
FC_FL07,SKU001569,561,175,386,112,1120,2025-07-24
FC_FL07,SKU001426,601,190,411,112,1120,2025-07-24
FC_FL07,SKU001097,241,64,177,56,560,2025-07-25
FC_FL07,SKU001803,1559,476,1083,210,2100,2025-07-25
FC_FL07,SKU000603,577,161,416,84,840,2025-07-23
FC_FL07,SKU001389,523,150,373,84,840,2025-07-24
FC_FL07,SKU001749,260,88,172,56,560,2025-07-27
FC_FL07,SKU001287,567,159,408,84,840,2025-07-22
FC_FL07,SKU000998,838,275,563,140,1400,2025-07-24
FC_FL07,SKU000139,1543,472,1071,210,2100,2025-07-22
FC_FL07,SKU000393,242,75,167,56,560,2025-07-25
FC_FL07,SKU000277,797,241,556,140,1400,2025-07-26
FC_FL07,SKU001652,241,69,172,56,560,2025-07-26
FC_FL07,SKU001796,616,194,422,112,1120,2025-07-22
FC_FL07,SKU001733,583,184,399,112,1120,2025-07-27
FC_FL07,SKU000431,801,245,556,140,1400,2025-07-21
FC_FL07,SKU001351,848,299,549,140,1400,2025-07-26
FC_FL07,SKU000528,849,263,586,140,1400,2025-07-24
FC_FL07,SKU000427,857,277,580,140,1400,2025-07-27
FC_FL07,SKU001654,244,69,175,56,560,2025-07-22
FC_FL07,SKU000276,569,169,400,84,840,2025-07-22
FC_FL07,SKU001303,1579,484,1095,210,2100,2025-07-23
FC_FL07,SKU000171,1579,455,1124,210,2100,2025-07-26
FC_FL07,SKU000030,652,191,461,112,1120,2025-07-26
FC_FL07,SKU000892,854,257,597,140,1400,2025-07-25
FC_FL07,SKU000922,233,72,161,56,560,2025-07-22
FC_FL07,SKU000183,639,189,450,112,1120,2025-07-27
FC_FL07,SKU000834,596,180,416,112,1120,2025-07-25
FC_FL07,SKU001296,600,179,421,112,1120,2025-07-22
FC_FL07,SKU001039,591,166,425,112,1120,2025-07-24
FC_FL07,SKU000979,835,248,587,140,1400,2025-07-22
FC_FL07,SKU000600,847,240,607,140,1400,2025-07-21
FC_FL07,SKU001278,535,155,380,84,840,2025-07-27
FC_FL07,SKU000902,238,59,179,56,560,2025-07-23
FC_FL07,SKU000475,547,167,380,84,840,2025-07-26
FC_FL07,SKU001442,871,268,603,140,1400,2025-07-24
FC_FL07,SKU000501,219,80,139,56,560,2025-07-24
FC_FL07,SKU000505,515,168,347,84,840,2025-07-26
FC_FL07,SKU001522,582,167,415,112,1120,2025-07-24
FC_FL07,SKU000279,1598,470,1128,210,2100,2025-07-25
FC_FL07,SKU000880,568,156,412,84,840,2025-07-25
FC_FL07,SKU001476,532,174,358,84,840,2025-07-25
FC_FL07,SKU001977,631,199,432,112,1120,2025-07-22
FC_FL07,SKU001211,626,183,443,112,1120,2025-07-25
FC_FL07,SKU000469,1593,515,1078,210,2100,2025-07-21
FC_FL07,SKU001585,1608,501,1107,210,2100,2025-07-26
FC_FL07,SKU000320,1569,473,1096,210,2100,2025-07-26
FC_FL07,SKU000410,551,157,394,84,840,2025-07-23
FC_FL07,SKU001584,615,195,420,112,1120,2025-07-23
FC_FL07,SKU001150,1502,463,1039,210,2100,2025-07-26
FC_FL07,SKU000934,514,151,363,84,840,2025-07-23
FC_FL07,SKU001340,810,244,566,140,1400,2025-07-26
FC_FL07,SKU001723,846,249,597,140,1400,2025-07-24
FC_FL07,SKU000947,569,145,424,112,1120,2025-07-23
FC_FL07,SKU000454,577,160,417,84,840,2025-07-25
FC_FL07,SKU000005,830,260,570,140,1400,2025-07-23
FC_FL07,SKU001441,529,164,365,84,840,2025-07-27
FC_FL07,SKU001390,542,144,398,84,840,2025-07-22
FC_FL07,SKU001683,230,64,166,56,560,2025-07-23
FC_FL07,SKU001056,817,250,567,140,1400,2025-07-22
FC_FL07,SKU000070,1572,438,1134,210,2100,2025-07-24
FC_FL07,SKU000110,866,266,600,140,1400,2025-07-25
FC_FL07,SKU000792,1593,488,1105,210,2100,2025-07-23
FC_FL07,SKU000281,1546,467,1079,210,2100,2025-07-21
FC_FL07,SKU000527,262,75,187,56,560,2025-07-27
FC_FL07,SKU000321,1543,459,1084,210,2100,2025-07-21
FC_FL07,SKU000074,1538,450,1088,210,2100,2025-07-21
FC_FL07,SKU000712,612,190,422,112,1120,2025-07-24
FC_FL07,SKU001467,628,184,444,112,1120,2025-07-27
FC_FL07,SKU000992,270,76,194,56,560,2025-07-23
FC_FL07,SKU000994,236,71,165,56,560,2025-07-21
FC_FL07,SKU000302,263,91,172,56,560,2025-07-24
FC_FL07,SKU000201,537,196,341,84,840,2025-07-23
FC_FL07,SKU000429,1661,476,1185,210,2100,2025-07-27
FC_FL07,SKU001482,847,235,612,140,1400,2025-07-25
FC_FL07,SKU001044,577,166,411,84,840,2025-07-23
FC_FL07,SKU001054,1574,481,1093,210,2100,2025-07-22
FC_FL07,SKU001518,852,256,596,140,1400,2025-07-23
FC_FL07,SKU001149,566,170,396,84,840,2025-07-21
FC_FL07,SKU000143,630,193,437,112,1120,2025-07-21
FC_FL07,SKU001350,614,169,445,84,840,2025-07-23
FC_FL07,SKU000544,622,179,443,112,1120,2025-07-25
FC_FL07,SKU000525,642,181,461,112,1120,2025-07-25
FC_FL07,SKU000874,525,148,377,84,840,2025-07-24
FC_FL07,SKU000134,1545,454,1091,210,2100,2025-07-27
FC_FL07,SKU000681,1526,435,1091,210,2100,2025-07-24
FC_FL07,SKU000613,240,82,158,56,560,2025-07-26
FC_FL07,SKU001785,1602,525,1077,210,2100,2025-07-24
FC_FL07,SKU001213,1599,472,1127,210,2100,2025-07-24
FC_FL07,SKU000549,559,182,377,84,840,2025-07-23
FC_FL07,SKU000193,658,190,468,112,1120,2025-07-25
FC_FL07,SKU001114,622,180,442,112,1120,2025-07-25
FC_FL07,SKU000761,618,195,423,112,1120,2025-07-26
FC_FL07,SKU001764,1537,441,1096,210,2100,2025-07-23
FC_FL07,SKU001648,245,72,173,56,560,2025-07-24
FC_FL07,SKU001055,643,179,464,112,1120,2025-07-22
FC_FL07,SKU000368,615,211,404,112,1120,2025-07-22
FC_FL07,SKU000982,211,68,143,56,560,2025-07-25
FC_FL07,SKU000649,572,173,399,84,840,2025-07-21
FC_FL07,SKU001960,605,171,434,112,1120,2025-07-27
FC_FL07,SKU000311,224,62,162,56,560,2025-07-23
FC_FL07,SKU000483,260,88,172,56,560,2025-07-24
FC_FL07,SKU001945,1581,488,1093,210,2100,2025-07-21
FC_FL07,SKU001119,1553,487,1066,210,2100,2025-07-23
FC_FL07,SKU000088,829,259,570,140,1400,2025-07-27
FC_FL07,SKU001179,513,153,360,84,840,2025-07-26
FC_FL07,SKU000248,1595,496,1099,210,2100,2025-07-24
FC_FL07,SKU000631,622,189,433,112,1120,2025-07-21
FC_FL07,SKU001644,1600,490,1110,210,2100,2025-07-23
FC_FL07,SKU000076,834,269,565,140,1400,2025-07-23
FC_FL07,SKU001867,650,192,458,112,1120,2025-07-24
FC_FL07,SKU000806,561,165,396,84,840,2025-07-25
FC_FL07,SKU001412,524,144,380,84,840,2025-07-24
FC_FL07,SKU001347,1611,470,1141,210,2100,2025-07-26
FC_FL07,SKU001873,248,66,182,56,560,2025-07-23
FC_FL07,SKU000927,512,146,366,84,840,2025-07-25
FC_FL07,SKU001620,866,276,590,140,1400,2025-07-23
FC_FL07,SKU001962,523,145,378,84,840,2025-07-25
FC_FL07,SKU000867,577,176,401,84,840,2025-07-25
FC_FL07,SKU001101,518,143,375,84,840,2025-07-22
FC_FL07,SKU001023,806,231,575,140,1400,2025-07-22
FC_FL07,SKU001742,580,179,401,84,840,2025-07-24
FC_FL07,SKU001082,241,67,174,56,560,2025-07-24
FC_FL07,SKU001418,852,250,602,140,1400,2025-07-22
FC_FL07,SKU001758,548,178,370,84,840,2025-07-26
FC_FL07,SKU001577,1590,479,1111,210,2100,2025-07-22
FC_FL07,SKU001778,278,82,196,56,560,2025-07-26
FC_FL07,SKU001814,779,225,554,140,1400,2025-07-26
FC_FL07,SKU000642,523,145,378,84,840,2025-07-21
FC_FL07,SKU000824,1584,526,1058,210,2100,2025-07-27
FC_FL07,SKU001619,850,251,599,140,1400,2025-07-27
FC_FL07,SKU000967,812,224,588,140,1400,2025-07-22
FC_FL07,SKU001085,878,258,620,140,1400,2025-07-25
FC_FL07,SKU001051,557,146,411,84,840,2025-07-26
FC_FL07,SKU001548,885,275,610,140,1400,2025-07-21
FC_FL07,SKU000780,637,188,449,112,1120,2025-07-22
FC_FL07,SKU001725,567,144,423,84,840,2025-07-23
FC_FL07,SKU001658,589,166,423,112,1120,2025-07-26
FC_FL07,SKU001971,541,155,386,84,840,2025-07-21
FC_FL07,SKU001137,581,164,417,112,1120,2025-07-22
FC_FL07,SKU001895,628,182,446,112,1120,2025-07-26
FC_FL07,SKU001994,852,270,582,140,1400,2025-07-25
FC_FL07,SKU000643,810,253,557,140,1400,2025-07-26
FC_FL07,SKU000458,236,72,164,56,560,2025-07-23
FC_FL07,SKU000956,888,262,626,140,1400,2025-07-23
FC_FL07,SKU000136,259,71,188,56,560,2025-07-22
FC_FL07,SKU001594,812,230,582,140,1400,2025-07-22
FC_FL07,SKU001702,600,172,428,112,1120,2025-07-26
FC_FL07,SKU001330,835,261,574,140,1400,2025-07-26
FC_FL07,SKU001001,1518,423,1095,210,2100,2025-07-25
FC_FL07,SKU001641,531,129,402,84,840,2025-07-24
FC_FL07,SKU000338,618,173,445,112,1120,2025-07-21
FC_FL07,SKU001090,243,62,181,56,560,2025-07-24
FC_FL07,SKU000587,860,259,601,140,1400,2025-07-24
FC_FL07,SKU000522,575,166,409,84,840,2025-07-26
FC_FL07,SKU001852,756,247,509,140,1400,2025-07-26
FC_FL07,SKU001291,1604,487,1117,210,2100,2025-07-23
FC_FL07,SKU000959,257,76,181,56,560,2025-07-21
FC_FL07,SKU001381,611,169,442,112,1120,2025-07-24
FC_FL07,SKU000037,625,175,450,112,1120,2025-07-25
FC_FL07,SKU001398,546,167,379,84,840,2025-07-23
FC_FL07,SKU000705,263,91,172,56,560,2025-07-23
FC_FL07,SKU000332,804,239,565,140,1400,2025-07-26
FC_FL07,SKU001281,1694,474,1220,210,2100,2025-07-25
FC_FL07,SKU000061,623,176,447,112,1120,2025-07-26
FC_FL07,SKU000369,827,261,566,140,1400,2025-07-22
FC_FL07,SKU001805,793,251,542,140,1400,2025-07-26
FC_FL07,SKU001768,273,90,183,56,560,2025-07-22
FC_FL07,SKU000624,849,277,572,140,1400,2025-07-26
FC_FL07,SKU000993,640,174,466,112,1120,2025-07-25
FC_FL07,SKU001999,252,69,183,56,560,2025-07-22
FC_FL07,SKU001439,1498,429,1069,210,2100,2025-07-24
FC_FL07,SKU001961,554,179,375,84,840,2025-07-23
FC_FL07,SKU001869,521,175,346,84,840,2025-07-27
FC_FL07,SKU001274,1617,463,1154,210,2100,2025-07-25
FC_FL07,SKU000206,856,268,588,140,1400,2025-07-21
FC_FL07,SKU000784,540,169,371,84,840,2025-07-25
FC_FL07,SKU001349,244,82,162,56,560,2025-07-23
FC_FL07,SKU001323,844,265,579,140,1400,2025-07-21
FC_FL07,SKU001168,1602,455,1147,210,2100,2025-07-21
FC_FL07,SKU001428,1628,500,1128,210,2100,2025-07-26
FC_FL07,SKU001537,885,259,626,140,1400,2025-07-27
FC_FL07,SKU000592,824,249,575,140,1400,2025-07-23
FC_FL07,SKU001704,600,171,429,112,1120,2025-07-23
FC_FL07,SKU001741,802,249,553,140,1400,2025-07-23
FC_FL07,SKU001821,263,76,187,56,560,2025-07-27
FC_FL07,SKU001070,842,224,618,140,1400,2025-07-21
FC_FL07,SKU000977,260,80,180,56,560,2025-07-26
FC_FL07,SKU000695,642,197,445,112,1120,2025-07-27
FC_FL07,SKU001984,526,205,321,84,840,2025-07-26
FC_FL07,SKU000034,623,182,441,112,1120,2025-07-23
FC_FL07,SKU000830,275,75,200,56,560,2025-07-25
FC_FL07,SKU000697,588,169,419,112,1120,2025-07-26
FC_FL07,SKU001813,820,273,547,140,1400,2025-07-23
FC_FL07,SKU000662,228,75,153,56,560,2025-07-23
FC_FL07,SKU000679,518,161,357,84,840,2025-07-21
FC_FL07,SKU000120,626,194,432,112,1120,2025-07-22
FC_FL07,SKU001874,1536,459,1077,210,2100,2025-07-27
FC_FL07,SKU000648,1661,478,1183,210,2100,2025-07-26
FC_FL07,SKU001802,520,128,392,84,840,2025-07-27
FC_FL07,SKU000584,587,184,403,112,1120,2025-07-22
FC_FL07,SKU001033,829,226,603,140,1400,2025-07-25
FC_FL07,SKU001363,253,72,181,56,560,2025-07-22
FC_FL07,SKU001415,253,75,178,56,560,2025-07-25
FC_FL07,SKU001771,535,173,362,84,840,2025-07-27
FC_FL07,SKU001791,897,286,611,140,1400,2025-07-27
FC_FL07,SKU001695,650,209,441,112,1120,2025-07-26
FC_FL07,SKU001595,1499,427,1072,210,2100,2025-07-26
FC_FL07,SKU001102,255,78,177,56,560,2025-07-23
FC_FL07,SKU001916,630,198,432,112,1120,2025-07-24
FC_FL07,SKU001332,267,74,193,56,560,2025-07-22
FC_FL07,SKU001469,1564,447,1117,210,2100,2025-07-21
FC_FL07,SKU001275,276,73,203,56,560,2025-07-25
FC_FL07,SKU000063,262,77,185,56,560,2025-07-26
FC_FL07,SKU001454,1589,475,1114,210,2100,2025-07-23
FC_FL07,SKU001106,1493,434,1059,210,2100,2025-07-24
FC_FL07,SKU000951,241,70,171,56,560,2025-07-24
FC_FL07,SKU001088,552,193,359,84,840,2025-07-25
FC_FL07,SKU000408,613,188,425,112,1120,2025-07-27
FC_FL07,SKU001963,578,194,384,84,840,2025-07-25
FC_FL07,SKU000044,249,81,168,56,560,2025-07-21
FC_FL07,SKU000052,241,56,185,56,560,2025-07-21
FC_FL07,SKU000181,839,269,570,140,1400,2025-07-24
FC_FL07,SKU000169,634,180,454,112,1120,2025-07-26
FC_FL07,SKU001410,260,68,192,56,560,2025-07-24
FC_FL07,SKU001067,1532,477,1055,210,2100,2025-07-26
FC_FL07,SKU001193,257,82,175,56,560,2025-07-22
FC_FL07,SKU000999,846,245,601,140,1400,2025-07-23
FC_FL07,SKU000152,240,82,158,56,560,2025-07-25
FC_FL07,SKU000894,578,184,394,112,1120,2025-07-22
FC_FL07,SKU001255,856,242,614,140,1400,2025-07-25
FC_FL07,SKU000213,284,91,193,56,560,2025-07-25
FC_FL07,SKU001112,299,82,217,56,560,2025-07-22
FC_FL07,SKU000337,250,75,175,56,560,2025-07-21
FC_FL07,SKU000822,256,83,173,56,560,2025-07-27
FC_FL07,SKU000948,1601,517,1084,210,2100,2025-07-26
FC_FL07,SKU000068,1524,440,1084,210,2100,2025-07-27
FC_FL07,SKU000969,278,83,195,56,560,2025-07-22
FC_FL07,SKU000810,658,190,468,112,1120,2025-07-27
FC_FL07,SKU000413,598,199,399,112,1120,2025-07-25
FC_FL07,SKU001596,594,176,418,112,1120,2025-07-27
FC_FL07,SKU001529,646,195,451,112,1120,2025-07-25
FC_FL07,SKU001265,833,215,618,140,1400,2025-07-23
FC_FL07,SKU000254,909,263,646,140,1400,2025-07-26
FC_FL07,SKU001660,532,170,362,84,840,2025-07-26
FC_FL07,SKU001474,1651,497,1154,210,2100,2025-07-26
FC_FL07,SKU001668,238,74,164,56,560,2025-07-26
FC_FL07,SKU001414,1627,520,1107,210,2100,2025-07-23
FC_FL07,SKU000166,606,175,431,112,1120,2025-07-25
FC_FL07,SKU000179,253,77,176,56,560,2025-07-25
FC_FL07,SKU001534,1556,441,1115,210,2100,2025-07-23
FC_FL07,SKU000425,896,274,622,140,1400,2025-07-25
FC_FL07,SKU000680,1570,501,1069,210,2100,2025-07-22
FC_FL07,SKU001484,521,170,351,84,840,2025-07-26
FC_FL07,SKU001403,250,88,162,56,560,2025-07-23
FC_FL07,SKU000743,1592,458,1134,210,2100,2025-07-25
FC_FL07,SKU001774,1623,491,1132,210,2100,2025-07-21
FC_FL07,SKU001638,235,76,159,56,560,2025-07-21
FC_FL07,SKU001318,533,169,364,84,840,2025-07-26
FC_FL07,SKU000224,284,82,202,56,560,2025-07-25
FC_FL07,SKU000370,795,244,551,140,1400,2025-07-25
FC_FL07,SKU000820,1561,452,1109,210,2100,2025-07-21
FC_FL07,SKU001575,253,72,181,56,560,2025-07-24
FC_FL07,SKU001048,243,64,179,56,560,2025-07-21
FC_FL07,SKU001568,860,253,607,140,1400,2025-07-27
FC_FL07,SKU001329,625,198,427,112,1120,2025-07-24
FC_FL07,SKU001943,1617,446,1171,210,2100,2025-07-22
FC_FL07,SKU000552,1544,484,1060,210,2100,2025-07-23
FC_FL07,SKU001245,632,201,431,112,1120,2025-07-27
FC_FL07,SKU001076,598,173,425,112,1120,2025-07-23
FC_FL07,SKU000909,517,151,366,84,840,2025-07-27
FC_FL07,SKU000373,259,91,168,56,560,2025-07-27
FC_FL07,SKU000318,575,179,396,84,840,2025-07-21
FC_FL07,SKU001775,618,178,440,112,1120,2025-07-22
FC_FL07,SKU000375,1513,483,1030,210,2100,2025-07-21
FC_FL07,SKU000660,555,186,369,112,1120,2025-07-26
FC_FL07,SKU000261,612,194,418,112,1120,2025-07-24
FC_FL07,SKU001711,552,171,381,84,840,2025-07-22
FC_FL07,SKU001206,569,141,428,84,840,2025-07-27
FC_FL07,SKU000848,808,246,562,140,1400,2025-07-22
FC_FL07,SKU001108,235,84,151,56,560,2025-07-21
FC_FL07,SKU000639,571,164,407,84,840,2025-07-26
FC_FL07,SKU001249,621,212,409,112,1120,2025-07-21
FC_FL07,SKU000363,616,193,423,112,1120,2025-07-27
FC_FL07,SKU001479,586,190,396,112,1120,2025-07-26
FC_FL07,SKU000033,1528,461,1067,210,2100,2025-07-27
FC_FL07,SKU001110,275,93,182,56,560,2025-07-27
FC_FL07,SKU000010,242,79,163,56,560,2025-07-25
FC_FL07,SKU000194,663,201,462,112,1120,2025-07-22
FC_FL07,SKU001346,833,257,576,140,1400,2025-07-27
FC_FL07,SKU001951,1599,483,1116,210,2100,2025-07-23
FC_FL07,SKU001806,857,282,575,140,1400,2025-07-25
FC_FL07,SKU001144,531,178,353,84,840,2025-07-26
FC_FL07,SKU000661,250,74,176,56,560,2025-07-21
FC_FL07,SKU001129,876,264,612,140,1400,2025-07-26
FC_FL07,SKU001795,832,240,592,140,1400,2025-07-26
FC_FL07,SKU000049,865,258,607,140,1400,2025-07-24
FC_FL07,SKU000290,589,180,409,84,840,2025-07-21
FC_FL07,SKU000424,622,204,418,112,1120,2025-07-23
FC_FL07,SKU001433,253,70,183,56,560,2025-07-27
FC_FL07,SKU000579,612,166,446,112,1120,2025-07-21
FC_FL07,SKU001223,579,175,404,112,1120,2025-07-22
FC_FL07,SKU000482,1522,457,1065,210,2100,2025-07-27
FC_FL07,SKU001675,816,270,546,140,1400,2025-07-21
FC_FL07,SKU000343,1616,483,1133,210,2100,2025-07-22
FC_FL07,SKU001127,622,179,443,112,1120,2025-07-23
FC_FL07,SKU000239,1590,480,1110,210,2100,2025-07-23
FC_FL07,SKU000718,563,152,411,84,840,2025-07-24
FC_FL07,SKU000081,517,177,340,84,840,2025-07-24
FC_FL07,SKU001407,879,266,613,140,1400,2025-07-25
FC_FL07,SKU000149,587,179,408,112,1120,2025-07-26
FC_FL07,SKU000596,568,147,421,84,840,2025-07-22
FC_FL07,SKU000916,254,67,187,56,560,2025-07-26
FC_FL07,SKU000647,258,68,190,56,560,2025-07-24
FC_FL07,SKU001198,830,236,594,140,1400,2025-07-22
FC_FL07,SKU000180,864,275,589,140,1400,2025-07-26
FC_FL07,SKU001964,839,250,589,140,1400,2025-07-25
FC_FL07,SKU000768,866,256,610,140,1400,2025-07-27
FC_FL07,SKU000494,529,171,358,84,840,2025-07-26
FC_FL07,SKU001115,885,281,604,140,1400,2025-07-25
FC_FL07,SKU000606,852,240,612,140,1400,2025-07-25
FC_FL07,SKU000023,640,179,461,112,1120,2025-07-23
FC_FL07,SKU000032,565,154,411,84,840,2025-07-25
FC_FL07,SKU001716,855,253,602,140,1400,2025-07-25
FC_FL07,SKU000586,596,178,418,112,1120,2025-07-27
FC_FL07,SKU001833,586,170,416,112,1120,2025-07-21
FC_FL07,SKU001458,270,99,171,56,560,2025-07-24
FC_FL07,SKU000464,276,74,202,56,560,2025-07-23
FC_FL07,SKU001501,1614,482,1132,210,2100,2025-07-27
FC_FL07,SKU001930,552,161,391,84,840,2025-07-27
FC_FL07,SKU001841,541,170,371,84,840,2025-07-23
FC_FL07,SKU001851,545,167,378,84,840,2025-07-23
FC_FL07,SKU001611,817,246,571,140,1400,2025-07-27
FC_FL07,SKU000225,815,239,576,140,1400,2025-07-23
FC_FL07,SKU001690,554,155,399,84,840,2025-07-23
FC_FL07,SKU001744,586,186,400,112,1120,2025-07-27
FC_FL07,SKU000255,855,246,609,140,1400,2025-07-24
FC_FL07,SKU001736,612,178,434,112,1120,2025-07-21
FC_FL07,SKU000015,1576,452,1124,210,2100,2025-07-22
FC_FL07,SKU001164,1619,502,1117,210,2100,2025-07-23
FC_FL07,SKU001380,277,69,208,56,560,2025-07-25
FC_FL07,SKU001694,246,81,165,56,560,2025-07-21
FC_FL07,SKU001221,606,194,412,112,1120,2025-07-26
FC_FL07,SKU000403,256,74,182,56,560,2025-07-25
FC_FL07,SKU000395,876,267,609,140,1400,2025-07-24
FC_FL07,SKU001645,805,217,588,140,1400,2025-07-27
FC_FL07,SKU000493,249,68,181,56,560,2025-07-27
FC_FL07,SKU000289,559,159,400,84,840,2025-07-25
FC_FL07,SKU000087,602,182,420,112,1120,2025-07-26
FC_FL07,SKU000667,256,80,176,56,560,2025-07-26
FC_FL07,SKU001800,836,209,627,140,1400,2025-07-24
FC_FL07,SKU001177,548,173,375,84,840,2025-07-23
FC_FL07,SKU000974,1492,476,1016,210,2100,2025-07-26
FC_FL07,SKU001721,808,246,562,140,1400,2025-07-23
FC_FL07,SKU001065,1516,429,1087,210,2100,2025-07-24
FC_FL07,SKU000463,282,90,192,56,560,2025-07-27
FC_FL07,SKU000813,536,154,382,84,840,2025-07-27
FC_FL07,SKU000727,1580,447,1133,210,2100,2025-07-24
FC_FL07,SKU001105,1572,463,1109,210,2100,2025-07-21
FC_FL07,SKU000256,642,205,437,112,1120,2025-07-26
FC_FL07,SKU001432,883,280,603,140,1400,2025-07-21
FC_FL07,SKU001253,236,64,172,56,560,2025-07-24
FC_FL07,SKU000185,849,241,608,140,1400,2025-07-24
FC_FL07,SKU000322,826,262,564,140,1400,2025-07-26
FC_FL07,SKU001634,1604,504,1100,210,2100,2025-07-22
FC_FL07,SKU001395,599,179,420,112,1120,2025-07-21
FC_FL07,SKU001515,1567,483,1084,210,2100,2025-07-22
FC_FL07,SKU001218,803,233,570,140,1400,2025-07-26
FC_FL07,SKU000839,276,78,198,56,560,2025-07-24
FC_FL07,SKU001397,531,175,356,84,840,2025-07-25
FC_FL07,SKU001457,1555,483,1072,210,2100,2025-07-24
FC_FL07,SKU000682,526,148,378,84,840,2025-07-22
FC_FL07,SKU001959,863,275,588,140,1400,2025-07-26
FC_FL07,SKU001279,235,76,159,56,560,2025-07-26
FC_FL07,SKU001342,533,167,366,84,840,2025-07-24
FC_FL07,SKU001242,850,252,598,140,1400,2025-07-26
FC_FL07,SKU001757,1488,434,1054,210,2100,2025-07-22
FC_FL07,SKU001430,1603,483,1120,210,2100,2025-07-27
FC_FL07,SKU001094,577,180,397,112,1120,2025-07-21
FC_FL07,SKU000211,863,255,608,140,1400,2025-07-26
FC_FL07,SKU000240,232,74,158,56,560,2025-07-25
FC_FL07,SKU000412,644,203,441,112,1120,2025-07-27
FC_FL07,SKU000945,627,174,453,112,1120,2025-07-21
FC_FL07,SKU001400,599,181,418,112,1120,2025-07-26
FC_FL07,SKU000228,635,235,400,112,1120,2025-07-23
FC_FL07,SKU000260,834,253,581,140,1400,2025-07-22
FC_FL07,SKU001502,560,190,370,84,840,2025-07-21
FC_FL07,SKU000379,657,208,449,112,1120,2025-07-21
FC_FL07,SKU001761,613,200,413,112,1120,2025-07-21
FC_FL07,SKU000987,1533,467,1066,210,2100,2025-07-26
FC_FL07,SKU000671,1631,476,1155,210,2100,2025-07-27
FC_FL07,SKU001290,255,78,177,56,560,2025-07-26
FC_FL07,SKU001319,275,91,184,56,560,2025-07-26
FC_FL07,SKU000232,599,186,413,112,1120,2025-07-25
FC_FL07,SKU000666,833,253,580,140,1400,2025-07-25
FC_FL07,SKU000021,835,247,588,140,1400,2025-07-21
FC_FL07,SKU000755,572,152,420,84,840,2025-07-21
FC_FL07,SKU001294,576,168,408,112,1120,2025-07-23
FC_FL07,SKU001672,542,170,372,84,840,2025-07-22
FC_FL07,SKU000759,502,152,350,84,840,2025-07-21
FC_FL07,SKU001886,563,164,399,84,840,2025-07-21
FC_FL07,SKU001682,880,257,623,140,1400,2025-07-24
FC_FL07,SKU000390,1571,467,1104,210,2100,2025-07-26
FC_FL07,SKU000736,558,191,367,84,840,2025-07-24
FC_FL07,SKU000445,837,263,574,140,1400,2025-07-22
FC_FL07,SKU000778,567,170,397,84,840,2025-07-23
FC_FL07,SKU000245,829,252,577,140,1400,2025-07-27
FC_FL07,SKU000098,1564,495,1069,210,2100,2025-07-23
FC_FL07,SKU001514,232,58,174,56,560,2025-07-22
FC_FL07,SKU000569,552,162,390,84,840,2025-07-24
FC_FL07,SKU001714,650,196,454,112,1120,2025-07-25
FC_FL07,SKU000480,1626,437,1189,210,2100,2025-07-24
FC_FL07,SKU001256,263,92,171,56,560,2025-07-23
FC_FL07,SKU001252,637,186,451,112,1120,2025-07-22
FC_FL07,SKU000860,859,248,611,140,1400,2025-07-21
FC_FL07,SKU000272,787,266,521,140,1400,2025-07-24
FC_FL07,SKU001465,849,262,587,140,1400,2025-07-22
FC_FL07,SKU000958,617,189,428,112,1120,2025-07-23
FC_FL07,SKU001992,250,68,182,56,560,2025-07-24
FC_FL07,SKU001651,566,175,391,84,840,2025-07-25
FC_FL07,SKU000334,902,321,581,140,1400,2025-07-25
FC_FL07,SKU001662,1583,491,1092,210,2100,2025-07-23
FC_FL07,SKU000186,586,198,388,112,1120,2025-07-22
FC_FL07,SKU000767,777,213,564,140,1400,2025-07-22
FC_FL07,SKU001926,647,178,469,112,1120,2025-07-21
FC_FL07,SKU001576,815,232,583,140,1400,2025-07-23
FC_FL07,SKU000858,538,166,372,84,840,2025-07-25
FC_FL07,SKU000439,263,73,190,56,560,2025-07-24
FC_FL07,SKU001459,590,184,406,112,1120,2025-07-21
FC_FL07,SKU000354,607,173,434,112,1120,2025-07-24
FC_FL07,SKU001240,1547,456,1091,210,2100,2025-07-22
FC_FL07,SKU000444,597,155,442,84,840,2025-07-21
FC_FL07,SKU001659,544,130,414,84,840,2025-07-23
FC_FL07,SKU000843,1628,478,1150,210,2100,2025-07-27
FC_FL07,SKU001276,609,170,439,112,1120,2025-07-25
FC_FL07,SKU000620,527,156,371,84,840,2025-07-25
FC_FL07,SKU000142,268,74,194,56,560,2025-07-24
FC_FL07,SKU001605,875,270,605,140,1400,2025-07-25
FC_FL07,SKU000589,621,170,451,112,1120,2025-07-22
FC_FL07,SKU001849,253,92,161,56,560,2025-07-24
FC_FL07,SKU000794,836,273,563,140,1400,2025-07-24
FC_FL07,SKU000511,265,73,192,56,560,2025-07-22
FC_FL07,SKU001707,534,165,369,84,840,2025-07-26
FC_FL07,SKU000353,1544,467,1077,210,2100,2025-07-25
FC_FL07,SKU000100,512,146,366,84,840,2025-07-24
FC_FL07,SKU001541,1586,477,1109,210,2100,2025-07-26
FC_FL07,SKU001855,1617,491,1126,210,2100,2025-07-27
FC_FL07,SKU000989,638,172,466,112,1120,2025-07-23
FC_FL07,SKU001120,244,72,172,56,560,2025-07-26
FC_FL07,SKU001731,1530,491,1039,210,2100,2025-07-24
FC_FL07,SKU001485,626,188,438,112,1120,2025-07-24
FC_FL07,SKU000901,618,171,447,112,1120,2025-07-21
FC_FL07,SKU001028,799,231,568,140,1400,2025-07-23
FC_FL07,SKU001311,868,253,615,140,1400,2025-07-25
FC_FL07,SKU001708,839,265,574,140,1400,2025-07-22
FC_FL07,SKU001379,541,173,368,84,840,2025-07-27
FC_FL07,SKU000775,544,164,380,84,840,2025-07-26
FC_FL07,SKU001858,1553,453,1100,210,2100,2025-07-25
FC_FL07,SKU000879,545,189,356,84,840,2025-07-26
FC_FL07,SKU001263,833,228,605,140,1400,2025-07-22
FC_FL07,SKU001557,602,166,436,112,1120,2025-07-21
FC_FL07,SKU000287,534,159,375,84,840,2025-07-23
FC_FL07,SKU000264,874,283,591,140,1400,2025-07-22
FC_FL07,SKU001706,245,57,188,56,560,2025-07-24
FC_FL07,SKU001988,867,245,622,140,1400,2025-07-23
FC_FL07,SKU000115,1600,501,1099,210,2100,2025-07-21
FC_FL07,SKU001566,1556,433,1123,210,2100,2025-07-25
FC_FL07,SKU001243,522,147,375,84,840,2025-07-22
FC_FL07,SKU000300,1553,480,1073,210,2100,2025-07-24
FC_FL07,SKU001416,1624,506,1118,210,2100,2025-07-23
FC_FL07,SKU001782,864,275,589,140,1400,2025-07-23
FC_FL07,SKU001018,522,172,350,84,840,2025-07-27
FC_FL07,SKU000333,593,196,397,112,1120,2025-07-27
FC_FL07,SKU001196,855,263,592,140,1400,2025-07-25
FC_FL07,SKU001968,525,152,373,84,840,2025-07-27
FC_FL07,SKU000392,608,183,425,112,1120,2025-07-24
FC_FL07,SKU001523,1581,459,1122,210,2100,2025-07-26
FC_FL07,SKU001235,1601,435,1166,210,2100,2025-07-21
FC_FL07,SKU000434,229,80,149,56,560,2025-07-21
FC_FL07,SKU001614,890,267,623,140,1400,2025-07-26
FC_FL07,SKU000436,865,265,600,140,1400,2025-07-27
FC_FL07,SKU001423,858,235,623,140,1400,2025-07-27
FC_FL07,SKU001013,256,85,171,56,560,2025-07-22
FC_FL07,SKU000446,1584,472,1112,210,2100,2025-07-27
FC_FL07,SKU000500,274,68,206,56,560,2025-07-27
FC_FL07,SKU001169,632,207,425,112,1120,2025-07-22
FC_FL07,SKU001550,257,76,181,56,560,2025-07-23
FC_FL07,SKU001404,1546,468,1078,210,2100,2025-07-26
FC_FL07,SKU000609,597,179,418,112,1120,2025-07-21
FC_FL07,SKU001665,576,173,403,84,840,2025-07-21
FC_FL07,SKU000782,829,228,601,140,1400,2025-07-24
FC_FL07,SKU000349,597,183,414,112,1120,2025-07-24
FC_FL07,SKU001924,839,255,584,140,1400,2025-07-21
FC_FL07,SKU001483,1568,517,1051,210,2100,2025-07-27
FC_FL07,SKU000939,566,174,392,112,1120,2025-07-22
FC_FL07,SKU001202,521,137,384,84,840,2025-07-22
FC_FL07,SKU001361,810,221,589,140,1400,2025-07-23
FC_FL07,SKU001857,258,72,186,56,560,2025-07-26
FC_FL07,SKU001877,868,248,620,140,1400,2025-07-24
FC_FL07,SKU001842,631,178,453,112,1120,2025-07-26
FC_FL07,SKU001362,529,164,365,84,840,2025-07-27
FC_FL07,SKU000817,1545,476,1069,210,2100,2025-07-21
FC_FL07,SKU001197,274,83,191,56,560,2025-07-25
FC_FL07,SKU001298,251,90,161,56,560,2025-07-27
FC_FL07,SKU000840,835,251,584,140,1400,2025-07-27
FC_FL07,SKU001069,859,259,600,140,1400,2025-07-26
FC_FL07,SKU001937,221,70,151,56,560,2025-07-27
FC_FL07,SKU000703,538,142,396,84,840,2025-07-24
FC_FL07,SKU000498,248,56,192,56,560,2025-07-27
FC_FL07,SKU001208,901,282,619,140,1400,2025-07-21
FC_FL07,SKU000091,800,229,571,140,1400,2025-07-23
FC_FL07,SKU000267,615,184,431,112,1120,2025-07-22
FC_FL07,SKU001848,843,228,615,140,1400,2025-07-22
FC_FL07,SKU000489,1532,471,1061,210,2100,2025-07-26
FC_FL07,SKU000724,544,176,368,84,840,2025-07-26
FC_FL07,SKU001074,276,95,181,56,560,2025-07-21
FC_FL07,SKU001251,245,68,177,56,560,2025-07-25
FC_FL07,SKU000862,566,168,398,84,840,2025-07-23
FC_FL07,SKU000632,804,234,570,140,1400,2025-07-27
FC_FL07,SKU000590,636,183,453,112,1120,2025-07-27
FC_FL07,SKU001549,597,197,400,112,1120,2025-07-25
FC_FL07,SKU001871,786,242,544,140,1400,2025-07-21
FC_FL07,SKU000227,237,75,162,56,560,2025-07-27
FC_FL07,SKU000550,855,239,616,140,1400,2025-07-25
FC_FL07,SKU000856,867,254,613,140,1400,2025-07-23
FC_FL07,SKU001227,1576,548,1028,210,2100,2025-07-24
FC_FL07,SKU000177,580,197,383,112,1120,2025-07-23
FC_FL07,SKU001438,823,244,579,140,1400,2025-07-26
FC_FL07,SKU001981,249,78,171,56,560,2025-07-21
FC_FL07,SKU000460,1604,496,1108,210,2100,2025-07-23
FC_FL07,SKU001267,881,271,610,140,1400,2025-07-27
FC_FL07,SKU000954,816,235,581,140,1400,2025-07-26
FC_FL07,SKU000943,546,154,392,84,840,2025-07-26
FC_FL07,SKU000636,809,241,568,140,1400,2025-07-23
FC_FL07,SKU000905,531,191,340,84,840,2025-07-23
FC_FL07,SKU000802,513,152,361,84,840,2025-07-27
FC_FL07,SKU000317,637,203,434,112,1120,2025-07-21
FC_FL07,SKU000722,621,185,436,112,1120,2025-07-21
FC_FL07,SKU000960,580,174,406,84,840,2025-07-24
FC_FL07,SKU000913,1553,457,1096,210,2100,2025-07-22
FC_FL07,SKU001134,1547,465,1082,210,2100,2025-07-24
FC_FL07,SKU001336,607,176,431,112,1120,2025-07-23
FC_FL07,SKU001579,259,75,184,56,560,2025-07-23
FC_FL07,SKU001375,1604,475,1129,210,2100,2025-07-26
FC_FL07,SKU000740,536,162,374,84,840,2025-07-24
FC_FL07,SKU001388,543,160,383,84,840,2025-07-24
FC_FL07,SKU001446,283,92,191,56,560,2025-07-22
FC_FL07,SKU000582,816,234,582,140,1400,2025-07-21
FC_FL07,SKU001449,1560,472,1088,210,2100,2025-07-24
FC_FL07,SKU001124,600,192,408,112,1120,2025-07-22
FC_FL07,SKU001212,884,247,637,140,1400,2025-07-23
FC_FL07,SKU001448,273,71,202,56,560,2025-07-22
FC_FL07,SKU001122,637,201,436,112,1120,2025-07-21
FC_FL07,SKU000495,248,72,176,56,560,2025-07-21
FC_FL07,SKU000657,580,161,419,112,1120,2025-07-27
FC_FL07,SKU001007,540,142,398,84,840,2025-07-25
FC_FL07,SKU001593,835,257,578,140,1400,2025-07-25
FC_FL07,SKU001769,246,78,168,56,560,2025-07-27
FC_FL07,SKU000210,548,177,371,84,840,2025-07-25
FC_FL07,SKU000019,1549,496,1053,210,2100,2025-07-23
FC_FL07,SKU001661,252,68,184,56,560,2025-07-23
FC_FL07,SKU000717,232,68,164,56,560,2025-07-23
FC_FL07,SKU001533,643,189,454,112,1120,2025-07-24
FC_FL07,SKU000230,230,73,157,56,560,2025-07-27
FC_FL07,SKU000187,540,175,365,84,840,2025-07-26
FC_FL07,SKU001295,1581,495,1086,210,2100,2025-07-27
FC_FL07,SKU001790,243,74,169,56,560,2025-07-21
FC_FL07,SKU001165,522,166,356,84,840,2025-07-23
FC_FL07,SKU001759,644,190,454,112,1120,2025-07-24
FC_FL07,SKU001327,630,185,445,112,1120,2025-07-23
FC_FL07,SKU000704,543,169,374,84,840,2025-07-22
FC_FL07,SKU001188,850,266,584,140,1400,2025-07-21
FC_FL07,SKU000067,1584,470,1114,210,2100,2025-07-24
FC_FL07,SKU001244,1497,442,1055,210,2100,2025-07-26
FC_FL07,SKU000496,556,160,396,84,840,2025-07-24
FC_FL07,SKU001904,795,228,567,140,1400,2025-07-25
FC_FL07,SKU000138,624,177,447,112,1120,2025-07-26
FC_FL07,SKU000451,243,65,178,56,560,2025-07-24
FC_FL07,SKU001942,238,72,166,56,560,2025-07-26
FC_FL07,SKU000980,279,65,214,56,560,2025-07-23
FC_FL07,SKU001983,1586,448,1138,210,2100,2025-07-23
FC_FL07,SKU000314,1593,481,1112,210,2100,2025-07-24
FC_FL07,SKU001238,546,143,403,84,840,2025-07-22
FC_FL07,SKU001763,808,222,586,140,1400,2025-07-24
FC_FL07,SKU000949,838,236,602,140,1400,2025-07-22
FC_FL07,SKU000116,1513,444,1069,210,2100,2025-07-25
FC_FL07,SKU001893,836,266,570,140,1400,2025-07-26
FC_FL07,SKU001629,246,69,177,56,560,2025-07-21
FC_FL07,SKU001953,1514,431,1083,210,2100,2025-07-26
FC_FL07,SKU000509,1484,457,1027,210,2100,2025-07-23
FC_FL07,SKU000038,1582,482,1100,210,2100,2025-07-22
FC_FL07,SKU001931,527,143,384,84,840,2025-07-23
FC_FL07,SKU000119,1566,498,1068,210,2100,2025-07-24
FC_FL07,SKU001087,239,61,178,56,560,2025-07-23
FC_FL07,SKU001464,1598,511,1087,210,2100,2025-07-22
FC_FL07,SKU001632,545,150,395,84,840,2025-07-22
FC_FL07,SKU000178,571,184,387,84,840,2025-07-26
FC_FL07,SKU000995,1604,463,1141,210,2100,2025-07-27
FC_FL07,SKU001037,633,206,427,112,1120,2025-07-22
FC_FL07,SKU000008,1554,494,1060,210,2100,2025-07-24
FC_FL07,SKU000462,1553,449,1104,210,2100,2025-07-26
FC_FL07,SKU000147,249,58,191,56,560,2025-07-25
FC_FL07,SKU001562,563,177,386,112,1120,2025-07-22
FC_FL07,SKU000316,858,258,600,140,1400,2025-07-26
FC_FL07,SKU001970,890,276,614,140,1400,2025-07-24
FC_FL07,SKU001653,1555,511,1044,210,2100,2025-07-21
FC_FL07,SKU000292,593,149,444,84,840,2025-07-23
FC_FL07,SKU000713,769,228,541,140,1400,2025-07-24
FC_FL07,SKU000765,619,183,436,112,1120,2025-07-23
FC_FL07,SKU001750,1568,481,1087,210,2100,2025-07-21
FC_FL07,SKU001103,617,187,430,112,1120,2025-07-21
FC_FL07,SKU001146,228,67,161,56,560,2025-07-25
FC_FL07,SKU000001,550,182,368,84,840,2025-07-25
FC_FL07,SKU000022,840,263,577,140,1400,2025-07-27
FC_FL07,SKU000658,1531,476,1055,210,2100,2025-07-24
FC_FL07,SKU000737,1571,460,1111,210,2100,2025-07-22
FC_FL07,SKU001950,844,257,587,140,1400,2025-07-26
FC_FL07,SKU001746,822,226,596,140,1400,2025-07-22
FC_FL07,SKU001838,1624,466,1158,210,2100,2025-07-26
FC_FL07,SKU001993,566,167,399,84,840,2025-07-23
FC_FL07,SKU001938,1600,487,1113,210,2100,2025-07-24
FC_FL07,SKU001472,885,252,633,140,1400,2025-07-21
FC_FL07,SKU001496,241,77,164,56,560,2025-07-25
FC_FL07,SKU000078,229,76,153,56,560,2025-07-27
FC_FL07,SKU001497,634,226,408,112,1120,2025-07-26
FC_FL07,SKU000538,850,259,591,140,1400,2025-07-25
FC_FL07,SKU000324,1550,454,1096,210,2100,2025-07-24
FC_FL07,SKU000448,607,161,446,112,1120,2025-07-22
FC_FL07,SKU001622,602,188,414,112,1120,2025-07-23
FC_FL07,SKU000222,885,273,612,140,1400,2025-07-23
FC_FL07,SKU000833,609,195,414,112,1120,2025-07-25
FC_FL07,SKU001271,824,219,605,140,1400,2025-07-23
FC_FL07,SKU000315,639,199,440,112,1120,2025-07-21
FC_FL07,SKU001863,495,146,349,84,840,2025-07-22
FC_FL07,SKU001680,561,140,421,84,840,2025-07-24
FC_FL07,SKU001545,565,178,387,84,840,2025-07-21
FC_FL07,SKU001538,909,252,657,140,1400,2025-07-27
FC_FL07,SKU000207,1563,444,1119,210,2100,2025-07-22
FC_FL07,SKU001564,639,185,454,112,1120,2025-07-22
FC_FL07,SKU001260,824,264,560,140,1400,2025-07-27
FC_FL07,SKU001191,558,162,396,84,840,2025-07-23
FC_FL07,SKU001987,269,66,203,56,560,2025-07-21
FC_FL07,SKU001226,272,85,187,56,560,2025-07-22
FC_FL07,SKU001732,1605,501,1104,210,2100,2025-07-22
FC_FL07,SKU001314,251,71,180,56,560,2025-07-21
FC_FL07,SKU000672,608,168,440,112,1120,2025-07-23
FC_FL07,SKU000397,1505,492,1013,210,2100,2025-07-23
FC_FL07,SKU000851,545,140,405,84,840,2025-07-26
FC_FL07,SKU001493,822,255,567,140,1400,2025-07-21
FC_FL07,SKU000845,529,149,380,84,840,2025-07-24
FC_FL07,SKU001980,825,248,577,140,1400,2025-07-24
FC_FL07,SKU001159,571,157,414,84,840,2025-07-21
FC_FL07,SKU000443,1508,470,1038,210,2100,2025-07-23
FC_FL07,SKU001217,1574,465,1109,210,2100,2025-07-27
FC_FL07,SKU000567,553,155,398,84,840,2025-07-25
FC_FL07,SKU001875,614,195,419,112,1120,2025-07-21
FC_FL07,SKU000981,522,152,370,84,840,2025-07-27
FC_FL07,SKU001130,1561,459,1102,210,2100,2025-07-22
FC_FL07,SKU000371,665,219,446,112,1120,2025-07-24
FC_FL07,SKU000449,259,75,184,56,560,2025-07-23
FC_FL07,SKU001891,227,73,154,56,560,2025-07-21
FC_FL07,SKU000532,593,182,411,112,1120,2025-07-25
FC_FL07,SKU001167,632,188,444,112,1120,2025-07-22
FC_FL07,SKU001052,861,241,620,140,1400,2025-07-27
FC_FL07,SKU000101,641,183,458,112,1120,2025-07-26
FC_FL07,SKU000274,555,176,379,84,840,2025-07-23
FC_FL07,SKU000925,232,53,179,56,560,2025-07-24
FC_FL07,SKU001335,823,274,549,140,1400,2025-07-25
FC_FL07,SKU001280,1533,455,1078,210,2100,2025-07-22
FC_FL07,SKU001998,853,266,587,140,1400,2025-07-22
FC_FL07,SKU001289,612,175,437,112,1120,2025-07-27
FC_FL07,SKU000676,1626,470,1156,210,2100,2025-07-25
FC_FL07,SKU001266,619,176,443,112,1120,2025-07-22
FC_FL07,SKU000821,563,157,406,84,840,2025-07-26
FC_FL07,SKU001507,1553,452,1101,210,2100,2025-07-22
FC_FL07,SKU000976,613,197,416,112,1120,2025-07-27
FC_FL07,SKU000278,861,249,612,140,1400,2025-07-25
FC_FL07,SKU000394,240,71,169,56,560,2025-07-25
FC_FL07,SKU001686,648,192,456,112,1120,2025-07-27
FC_FL07,SKU000309,629,175,454,84,840,2025-07-25
FC_FL07,SKU000597,542,165,377,84,840,2025-07-27
FC_FL07,SKU001180,868,266,602,140,1400,2025-07-23
FC_FL07,SKU000174,565,167,398,84,840,2025-07-22
FC_FL07,SKU000746,833,235,598,140,1400,2025-07-25
FC_FL07,SKU000764,641,192,449,112,1120,2025-07-21
FC_FL07,SKU001929,544,183,361,84,840,2025-07-22
FC_FL07,SKU001166,648,181,467,112,1120,2025-07-26
FC_FL07,SKU001921,260,72,188,56,560,2025-07-27
FC_FL07,SKU001027,1554,465,1089,210,2100,2025-07-26
FC_FL07,SKU000270,279,84,195,56,560,2025-07-23
FC_FL07,SKU000455,518,139,379,84,840,2025-07-24
FC_FL07,SKU001436,587,179,408,112,1120,2025-07-27
FC_FL07,SKU000329,530,161,369,84,840,2025-07-26
FC_FL07,SKU000710,268,76,192,56,560,2025-07-26
FC_FL07,SKU001839,860,264,596,140,1400,2025-07-25
FC_FL07,SKU000216,1535,480,1055,210,2100,2025-07-25
FC_FL07,SKU001909,1614,493,1121,210,2100,2025-07-22
FC_FL07,SKU000065,525,161,364,84,840,2025-07-22
FC_FL07,SKU001671,606,174,432,112,1120,2025-07-27
FC_FL07,SKU000827,542,141,401,84,840,2025-07-21
FC_FL07,SKU001348,824,244,580,140,1400,2025-07-25
FC_FL07,SKU000223,266,88,178,56,560,2025-07-25
FC_FL07,SKU001344,1639,464,1175,210,2100,2025-07-24
FC_FL07,SKU000506,634,162,472,112,1120,2025-07-22
FC_FL07,SKU001185,616,182,434,112,1120,2025-07-22
FC_FL07,SKU001157,1567,465,1102,210,2100,2025-07-22
FC_FL07,SKU001664,259,87,172,56,560,2025-07-21
FC_FL07,SKU000345,1571,434,1137,210,2100,2025-07-25
FC_FL07,SKU000325,590,189,401,112,1120,2025-07-23
FC_FL07,SKU001009,1516,441,1075,210,2100,2025-07-21
FC_FL07,SKU000404,628,184,444,112,1120,2025-07-25
FC_FL07,SKU001985,548,162,386,84,840,2025-07-22
FC_FL07,SKU001720,1576,495,1081,210,2100,2025-07-25
FC_FL07,SKU001220,1537,456,1081,210,2100,2025-07-25
FC_FL07,SKU001214,1531,475,1056,210,2100,2025-07-25
FC_FL07,SKU000832,543,172,371,84,840,2025-07-26
FC_FL07,SKU000560,231,76,155,56,560,2025-07-27
FC_FL07,SKU000148,1540,449,1091,210,2100,2025-07-25
FC_FL07,SKU000402,1578,459,1119,210,2100,2025-07-26
FC_FL07,SKU001602,843,279,564,140,1400,2025-07-22
FC_FL07,SKU001828,834,239,595,140,1400,2025-07-23
FC_FL07,SKU001029,636,191,445,112,1120,2025-07-24
FC_FL07,SKU001547,1605,499,1106,210,2100,2025-07-21
FC_FL07,SKU000013,607,162,445,112,1120,2025-07-22
FC_FL07,SKU001246,1547,514,1033,210,2100,2025-07-22
FC_FL07,SKU000523,577,173,404,112,1120,2025-07-22
FC_FL07,SKU001779,1549,457,1092,210,2100,2025-07-27
FC_FL07,SKU001000,1541,484,1057,210,2100,2025-07-27
FC_FL07,SKU000348,661,189,472,112,1120,2025-07-21
FC_FL07,SKU001304,259,73,186,56,560,2025-07-21
FC_FL07,SKU001936,1583,489,1094,210,2100,2025-07-24
FC_FL07,SKU000935,1540,429,1111,210,2100,2025-07-23
FC_FL07,SKU001990,638,179,459,112,1120,2025-07-23
FC_FL07,SKU001131,787,218,569,140,1400,2025-07-27
FC_FL07,SKU001057,582,196,386,84,840,2025-07-24
FC_FL07,SKU000876,824,262,562,140,1400,2025-07-23
FC_FL07,SKU001417,1564,437,1127,210,2100,2025-07-24
FC_FL07,SKU000441,259,83,176,56,560,2025-07-26
FC_FL07,SKU001099,1575,493,1082,210,2100,2025-07-25
FC_FL07,SKU001687,236,61,175,56,560,2025-07-24
FC_FL07,SKU001922,822,242,580,140,1400,2025-07-25
FC_FL07,SKU001669,542,174,368,84,840,2025-07-24
FC_FL07,SKU001666,1540,462,1078,210,2100,2025-07-25
FC_FL07,SKU000358,256,70,186,56,560,2025-07-21
FC_FL07,SKU000137,1571,452,1119,210,2100,2025-07-27
FC_FL07,SKU001807,554,202,352,84,840,2025-07-24
FC_FL07,SKU000991,899,283,616,140,1400,2025-07-24
FC_FL07,SKU000530,608,169,439,112,1120,2025-07-24
FC_FL07,SKU000675,1622,500,1122,210,2100,2025-07-27
FC_FL07,SKU000897,263,93,170,56,560,2025-07-27
FC_FL07,SKU001843,607,185,422,112,1120,2025-07-25
FC_FL07,SKU001536,273,84,189,56,560,2025-07-27
FC_FL07,SKU000269,253,89,164,56,560,2025-07-21
FC_FL07,SKU000985,522,143,379,84,840,2025-07-25
FC_FL07,SKU001161,587,181,406,112,1120,2025-07-27
FC_FL07,SKU000367,582,200,382,112,1120,2025-07-21
FC_FL07,SKU000684,854,247,607,140,1400,2025-07-24
FC_FL07,SKU000546,226,73,153,56,560,2025-07-23
FC_FL07,SKU000933,556,168,388,84,840,2025-07-27
FC_FL07,SKU001284,821,268,553,140,1400,2025-07-26
FC_FL07,SKU001944,1600,470,1130,210,2100,2025-07-27
FC_FL07,SKU001440,1605,481,1124,210,2100,2025-07-27
FC_FL07,SKU000340,625,185,440,112,1120,2025-07-27
FC_FL07,SKU000655,1534,452,1082,210,2100,2025-07-24
FC_FL07,SKU000696,1518,434,1084,210,2100,2025-07-27
FC_FL07,SKU000996,867,281,586,140,1400,2025-07-24
FC_FL07,SKU001495,246,72,174,56,560,2025-07-24
FC_FL07,SKU000762,796,256,540,140,1400,2025-07-21
FC_FL07,SKU001734,647,203,444,112,1120,2025-07-25
FC_FL07,SKU001396,600,163,437,112,1120,2025-07-21
FC_FL07,SKU001627,773,241,532,140,1400,2025-07-22
FC_FL07,SKU001544,591,182,409,112,1120,2025-07-25
FC_FL07,SKU001823,245,84,161,56,560,2025-07-21
FC_FL07,SKU000610,260,68,192,56,560,2025-07-27
FC_FL07,SKU001624,1543,463,1080,210,2100,2025-07-25
FC_FL07,SKU000409,604,165,439,112,1120,2025-07-24
FC_FL07,SKU001918,825,265,560,140,1400,2025-07-21
FC_FL07,SKU001907,1616,461,1155,210,2100,2025-07-25
FC_FL07,SKU000405,1554,505,1049,210,2100,2025-07-22
FC_FL07,SKU000133,541,170,371,84,840,2025-07-22
FC_FL07,SKU001884,542,163,379,84,840,2025-07-27
FC_FL07,SKU001189,584,160,424,112,1120,2025-07-27
FC_FL07,SKU001359,580,187,393,84,840,2025-07-27
FC_FL07,SKU001792,865,248,617,140,1400,2025-07-21
FC_FL07,SKU001705,238,70,168,56,560,2025-07-23
FC_FL07,SKU001553,603,178,425,84,840,2025-07-21
FC_FL07,SKU000915,254,70,184,56,560,2025-07-27
FC_FL07,SKU001745,643,184,459,112,1120,2025-07-26
FC_FL07,SKU000503,238,81,157,56,560,2025-07-27
FC_FL07,SKU001528,534,154,380,84,840,2025-07-23
FC_FL07,SKU001604,261,73,188,56,560,2025-07-21
FC_FL07,SKU000365,1541,462,1079,210,2100,2025-07-27
FC_FL07,SKU001071,274,105,169,56,560,2025-07-27
FC_FL07,SKU001282,802,259,543,140,1400,2025-07-22
FC_FL07,SKU000197,1617,486,1131,210,2100,2025-07-25
FC_FL07,SKU000698,1633,511,1122,210,2100,2025-07-23
FC_FL07,SKU001540,832,239,593,140,1400,2025-07-21
FC_FL07,SKU000564,619,193,426,112,1120,2025-07-22
FC_FL07,SKU001975,812,239,573,140,1400,2025-07-23
FC_FL07,SKU000871,608,176,432,112,1120,2025-07-23
FC_FL07,SKU000154,620,171,449,112,1120,2025-07-23
FC_FL07,SKU000450,606,192,414,112,1120,2025-07-25
FC_FL07,SKU001608,610,188,422,112,1120,2025-07-26
FC_FL07,SKU000426,1589,500,1089,210,2100,2025-07-26
FC_FL07,SKU000388,601,170,431,112,1120,2025-07-21
FC_FL07,SKU001903,212,53,159,56,560,2025-07-25
FC_FL07,SKU000466,868,256,612,140,1400,2025-07-22
FC_FL07,SKU000468,807,243,564,140,1400,2025-07-27
FC_FL07,SKU001002,816,251,565,140,1400,2025-07-26
FC_FL07,SKU000382,641,185,456,112,1120,2025-07-22
FC_FL07,SKU000190,1513,444,1069,210,2100,2025-07-25
FC_FL07,SKU001445,634,195,439,112,1120,2025-07-23
FC_FL07,SKU000173,1589,450,1139,210,2100,2025-07-27
FC_FL07,SKU000882,573,187,386,84,840,2025-07-24
FC_FL07,SKU000877,1543,414,1129,210,2100,2025-07-22
FC_FL07,SKU000797,1560,457,1103,210,2100,2025-07-22
FC_FL07,SKU000593,836,258,578,140,1400,2025-07-26
FC_FL07,SKU001787,836,260,576,140,1400,2025-07-22
FC_FL07,SKU001689,866,271,595,140,1400,2025-07-23
FC_FL07,SKU000330,1598,517,1081,210,2100,2025-07-22
FC_FL07,SKU000866,622,180,442,112,1120,2025-07-25
FC_FL07,SKU001058,261,64,197,56,560,2025-07-23
FC_FL07,SKU000855,610,210,400,112,1120,2025-07-24
FC_FL07,SKU001181,559,180,379,84,840,2025-07-22
FC_FL07,SKU000541,550,163,387,84,840,2025-07-25
FC_FL07,SKU001258,595,171,424,112,1120,2025-07-27
FC_FL07,SKU001526,832,233,599,140,1400,2025-07-27
FC_FL07,SKU001583,546,159,387,84,840,2025-07-27
FC_FL07,SKU001141,1542,484,1058,210,2100,2025-07-24
FC_FL07,SKU001563,644,176,468,112,1120,2025-07-21
FC_FL07,SKU000640,246,72,174,56,560,2025-07-24
FC_FL07,SKU001933,1592,515,1077,210,2100,2025-07-21
FC_FL07,SKU001603,252,71,181,56,560,2025-07-26
FC_FL07,SKU000984,626,191,435,112,1120,2025-07-23
FC_FL07,SKU001801,838,260,578,140,1400,2025-07-26
FC_FL07,SKU001325,594,188,406,112,1120,2025-07-24
FC_FL07,SKU000623,822,249,573,140,1400,2025-07-23
FC_FL07,SKU001343,519,184,335,84,840,2025-07-22
FC_FL07,SKU000105,1534,453,1081,210,2100,2025-07-22
FC_FL07,SKU000711,638,209,429,112,1120,2025-07-22
FC_FL07,SKU000787,270,76,194,56,560,2025-07-22
FC_FL07,SKU001324,629,194,435,112,1120,2025-07-22
FC_FL07,SKU001060,1546,496,1050,210,2100,2025-07-24
FC_FL07,SKU000524,841,259,582,140,1400,2025-07-24
FC_FL07,SKU001079,274,70,204,56,560,2025-07-24
FC_FL07,SKU000783,563,172,391,84,840,2025-07-24
FC_FL07,SKU001973,515,149,366,84,840,2025-07-27
FC_FL07,SKU000808,1568,459,1109,210,2100,2025-07-25
FC_FL07,SKU000031,252,83,169,56,560,2025-07-21
FC_FL07,SKU000859,609,183,426,112,1120,2025-07-22
FC_FL07,SKU000777,1533,476,1057,210,2100,2025-07-24
FC_FL07,SKU001681,829,260,569,140,1400,2025-07-25
FC_FL07,SKU001424,1612,468,1144,210,2100,2025-07-21
FC_FL07,SKU001630,613,162,451,112,1120,2025-07-21
FC_FL07,SKU000247,839,256,583,140,1400,2025-07-21
FC_FL07,SKU000884,643,167,476,112,1120,2025-07-25
FC_FL07,SKU001283,834,242,592,140,1400,2025-07-27
FC_FL07,SKU001096,820,239,581,140,1400,2025-07-22
FC_FL07,SKU001655,618,182,436,112,1120,2025-07-21
FC_FL07,SKU000326,259,103,156,56,560,2025-07-27
FC_FL07,SKU001136,560,167,393,84,840,2025-07-22
FC_FL07,SKU001341,863,259,604,140,1400,2025-07-23
FC_FL07,SKU001967,644,191,453,112,1120,2025-07-26
FC_FL07,SKU001421,592,167,425,112,1120,2025-07-26
FC_FL07,SKU001011,844,257,587,140,1400,2025-07-26
FC_FL07,SKU000164,656,216,440,112,1120,2025-07-23
FC_FL07,SKU001201,580,171,409,112,1120,2025-07-21
FC_FL07,SKU000749,232,66,166,56,560,2025-07-25
FC_FL07,SKU000491,561,161,400,84,840,2025-07-22
FC_FL07,SKU001635,546,194,352,84,840,2025-07-24
FC_FL07,SKU000351,537,170,367,84,840,2025-07-25
FC_FL07,SKU000453,1553,479,1074,210,2100,2025-07-21
FC_FL07,SKU000249,652,209,443,112,1120,2025-07-26
FC_FL07,SKU000888,890,254,636,140,1400,2025-07-23
FC_FL07,SKU001237,563,167,396,84,840,2025-07-26
FC_FL07,SKU001812,851,264,587,140,1400,2025-07-23
FC_FL07,SKU001555,849,264,585,140,1400,2025-07-21
FC_FL07,SKU001588,566,173,393,84,840,2025-07-24
FC_FL07,SKU000807,245,77,168,56,560,2025-07-21
FC_FL07,SKU000477,521,164,357,84,840,2025-07-23
FC_FL07,SKU001034,869,232,637,140,1400,2025-07-23
FC_FL07,SKU000499,609,181,428,112,1120,2025-07-24
FC_FL07,SKU000160,280,81,199,56,560,2025-07-21
FC_FL07,SKU001519,542,156,386,84,840,2025-07-24
FC_FL07,SKU001466,543,175,368,84,840,2025-07-24
FC_FL07,SKU000588,829,265,564,140,1400,2025-07-21
FC_FL07,SKU001461,257,71,186,56,560,2025-07-22
FC_FL07,SKU001986,1536,443,1093,210,2100,2025-07-22
FC_FL07,SKU001722,217,67,150,56,560,2025-07-21
FC_FL07,SKU000090,1652,478,1174,210,2100,2025-07-26
FC_FL07,SKU001859,594,199,395,84,840,2025-07-27
FC_FL07,SKU000972,527,162,365,84,840,2025-07-25
FC_FL07,SKU000196,510,138,372,84,840,2025-07-26
FC_FL07,SKU000918,595,164,431,112,1120,2025-07-23
FC_FL07,SKU001377,1568,495,1073,210,2100,2025-07-24
FC_FL07,SKU001195,555,163,392,84,840,2025-07-23
FC_FL07,SKU000108,1523,448,1075,210,2100,2025-07-25
FC_FL07,SKU001613,612,191,421,112,1120,2025-07-21
FC_FL07,SKU000773,513,173,340,84,840,2025-07-24
FC_FL07,SKU000893,525,172,353,84,840,2025-07-25
FC_FL07,SKU000872,876,263,613,140,1400,2025-07-25
FC_FL07,SKU000548,263,78,185,56,560,2025-07-21
FC_FL07,SKU001078,816,263,553,140,1400,2025-07-22
FC_FL07,SKU001679,1583,467,1116,210,2100,2025-07-22
FC_FL07,SKU001080,256,71,185,56,560,2025-07-21
FC_FL07,SKU001160,523,185,338,84,840,2025-07-24
FC_FL07,SKU000129,614,164,450,112,1120,2025-07-23
FC_FL07,SKU001093,257,81,176,56,560,2025-07-22
FC_FL07,SKU000964,1546,459,1087,210,2100,2025-07-22
FC_FL07,SKU001016,549,146,403,84,840,2025-07-27
FC_FL07,SKU000547,844,241,603,140,1400,2025-07-26
FC_FL07,SKU000355,836,243,593,140,1400,2025-07-27
FC_FL07,SKU001693,588,184,404,112,1120,2025-07-26
FC_FL07,SKU000551,843,250,593,140,1400,2025-07-26
FC_FL07,SKU001934,1580,492,1088,210,2100,2025-07-26
FC_FL07,SKU001678,241,72,169,56,560,2025-07-26
FC_FL07,SKU001233,579,186,393,112,1120,2025-07-25
FC_FL07,SKU000513,854,277,577,140,1400,2025-07-25
FC_FL07,SKU000430,817,268,549,140,1400,2025-07-24
FC_FL07,SKU001860,262,76,186,56,560,2025-07-25
FC_FL07,SKU001780,554,165,389,84,840,2025-07-27
FC_FL07,SKU000253,536,139,397,84,840,2025-07-23
FC_FL07,SKU000079,603,185,418,112,1120,2025-07-25
FC_FL07,SKU001560,1549,453,1096,210,2100,2025-07-23
FC_FL07,SKU000537,616,183,433,112,1120,2025-07-23
FC_FL07,SKU001752,262,56,206,56,560,2025-07-22
FC_FL07,SKU001989,1589,507,1082,210,2100,2025-07-21
FC_FL07,SKU000715,519,156,363,84,840,2025-07-27
FC_FL07,SKU001900,546,161,385,84,840,2025-07-24
FC_FL07,SKU001019,1546,470,1076,210,2100,2025-07-27
FC_FL07,SKU001578,636,179,457,112,1120,2025-07-22
FC_FL07,SKU001765,887,273,614,140,1400,2025-07-25
FC_FL07,SKU001338,1648,469,1179,210,2100,2025-07-27
FC_FL07,SKU000150,774,235,539,140,1400,2025-07-25
FC_FL07,SKU000865,1609,465,1144,210,2100,2025-07-23
FC_FL07,SKU001360,1561,465,1096,210,2100,2025-07-22
FC_FL07,SKU001762,235,74,161,56,560,2025-07-21
FC_FL07,SKU001818,1544,484,1060,210,2100,2025-07-27
FC_FL07,SKU001229,242,78,164,56,560,2025-07-26
FC_FL07,SKU001581,847,257,590,140,1400,2025-07-21
FC_FL07,SKU000653,239,75,164,56,560,2025-07-21
FC_FL07,SKU000490,576,179,397,112,1120,2025-07-24
FC_FL07,SKU001182,875,267,608,140,1400,2025-07-25
FC_FL07,SKU001384,1531,472,1059,210,2100,2025-07-22
FC_FL07,SKU000472,257,82,175,56,560,2025-07-27
FC_FL07,SKU000988,551,149,402,84,840,2025-07-26
FC_FL07,SKU001490,527,154,373,84,840,2025-07-21
FC_FL07,SKU000536,1579,453,1126,210,2100,2025-07-22
FC_FL07,SKU001520,554,164,390,84,840,2025-07-26
FC_FL07,SKU000857,1590,481,1109,210,2100,2025-07-23
FC_FL07,SKU001751,594,188,406,112,1120,2025-07-22
FC_FL07,SKU001452,237,85,152,56,560,2025-07-24
FC_FL07,SKU001232,1546,492,1054,210,2100,2025-07-25
FC_FL07,SKU000347,574,172,402,84,840,2025-07-26
FC_FL07,SKU001091,1631,519,1112,210,2100,2025-07-27
FC_FL07,SKU000156,283,96,187,56,560,2025-07-23
FC_FL07,SKU001219,618,201,417,112,1120,2025-07-22
FC_FL07,SKU001320,889,275,614,140,1400,2025-07-24
FC_FL07,SKU000020,529,132,397,84,840,2025-07-25
FC_FL07,SKU000645,632,183,449,112,1120,2025-07-24
FC_FL07,SKU000928,261,74,187,56,560,2025-07-22
FC_FL07,SKU001492,239,91,148,56,560,2025-07-25
FC_FL07,SKU001615,1521,417,1104,210,2100,2025-07-21
FC_FL07,SKU000122,851,256,595,140,1400,2025-07-27
FC_FL07,SKU000117,847,245,602,140,1400,2025-07-27
FC_FL07,SKU000118,849,280,569,140,1400,2025-07-23
FC_FL07,SKU001509,598,217,381,112,1120,2025-07-23
FC_FL07,SKU001059,1495,488,1007,210,2100,2025-07-22
FC_FL07,SKU001719,642,186,456,112,1120,2025-07-24
FC_FL07,SKU000622,1653,515,1138,210,2100,2025-07-23
FC_FL07,SKU000846,771,221,550,140,1400,2025-07-25
FC_FL07,SKU000420,502,145,357,84,840,2025-07-27
FC_FL07,SKU001738,1538,469,1069,210,2100,2025-07-26
FC_FL07,SKU000849,1542,430,1112,210,2100,2025-07-24
FC_FL07,SKU001709,261,68,193,56,560,2025-07-26
FC_FL07,SKU000920,237,66,171,56,560,2025-07-26
FC_FL07,SKU001902,618,180,438,112,1120,2025-07-23
FC_FL07,SKU000904,230,64,166,56,560,2025-07-22
FC_FL07,SKU001480,605,189,416,112,1120,2025-07-24
FC_FL07,SKU000714,245,63,182,56,560,2025-07-26
FC_FL07,SKU000835,1527,476,1051,210,2100,2025-07-22
FC_FL07,SKU001063,835,230,605,140,1400,2025-07-24
FC_FL07,SKU000625,1556,539,1017,210,2100,2025-07-22
FC_FL07,SKU000734,528,145,383,84,840,2025-07-23
FC_FL07,SKU000510,1601,456,1145,210,2100,2025-07-22
FC_FL07,SKU001829,1644,491,1153,210,2100,2025-07-23
FC_FL07,SKU001845,539,149,390,84,840,2025-07-23
FC_FL07,SKU000153,647,161,486,112,1120,2025-07-22
FC_FL07,SKU001826,623,176,447,112,1120,2025-07-24
FC_FL07,SKU000029,1542,452,1090,210,2100,2025-07-21
FC_FL07,SKU001194,559,191,368,84,840,2025-07-25
FC_FL07,SKU001365,1617,480,1137,210,2100,2025-07-21
FC_FL07,SKU001956,1631,431,1200,210,2100,2025-07-27
FC_FL07,SKU001062,229,73,156,56,560,2025-07-25
FC_FL07,SKU000168,866,276,590,140,1400,2025-07-24
FC_FL07,SKU001046,602,176,426,112,1120,2025-07-25
FC_FL07,SKU000298,623,188,435,112,1120,2025-07-21
FC_FL07,SKU001354,571,181,390,84,840,2025-07-25
FC_FL07,SKU000595,1494,470,1024,210,2100,2025-07-25
FC_FL07,SKU000829,854,265,589,140,1400,2025-07-22
FC_FL07,SKU000638,837,246,591,140,1400,2025-07-26
FC_FL07,SKU000312,850,235,615,140,1400,2025-07-24
FC_FL07,SKU001155,524,151,373,84,840,2025-07-25
FC_FL07,SKU001453,556,160,396,84,840,2025-07-21
FC_FL07,SKU000924,1550,504,1046,210,2100,2025-07-25
FC_FL07,SKU000376,1571,493,1078,210,2100,2025-07-25
FC_FL07,SKU000487,240,76,164,56,560,2025-07-25
FC_FL07,SKU000955,525,147,378,84,840,2025-07-27
FC_FL07,SKU001808,631,177,454,112,1120,2025-07-23
FC_FL07,SKU000204,542,158,384,84,840,2025-07-25
FC_FL07,SKU001475,256,74,182,56,560,2025-07-22
FC_FL07,SKU000205,1563,471,1092,210,2100,2025-07-26
FC_FL07,SKU000621,256,70,186,56,560,2025-07-22
FC_FL07,SKU000689,212,70,142,56,560,2025-07-23
FC_FL07,SKU001068,576,196,380,84,840,2025-07-24
FC_FL07,SKU000868,858,275,583,140,1400,2025-07-23
FC_FL07,SKU000220,770,229,541,140,1400,2025-07-27
FC_FL07,SKU000323,545,146,399,84,840,2025-07-21
FC_FL07,SKU000125,1521,458,1063,210,2100,2025-07-22
FC_FL07,SKU001906,552,174,378,84,840,2025-07-25
FC_FL07,SKU001650,820,252,568,140,1400,2025-07-27
FC_FL07,SKU001162,620,184,436,112,1120,2025-07-21
FC_FL07,SKU001125,631,174,457,112,1120,2025-07-23
FC_FL07,SKU001443,902,252,650,140,1400,2025-07-24
FC_FL07,SKU000699,236,70,166,56,560,2025-07-25
FC_FL07,SKU001254,1640,524,1116,210,2100,2025-07-23
FC_FL07,SKU001269,1525,463,1062,210,2100,2025-07-22
FC_FL07,SKU001210,811,223,588,140,1400,2025-07-26
FC_FL07,SKU000619,1628,479,1149,210,2100,2025-07-24
FC_FL07,SKU001334,285,86,199,56,560,2025-07-26
FC_FL07,SKU000417,235,91,144,56,560,2025-07-26
FC_FL07,SKU001908,1643,486,1157,210,2100,2025-07-21
FC_FL07,SKU001405,865,294,571,140,1400,2025-07-24
FC_FL07,SKU001378,605,167,438,112,1120,2025-07-24
FC_FL07,SKU000162,1616,471,1145,210,2100,2025-07-21
FC_FL07,SKU000086,531,166,365,84,840,2025-07-24
FC_FL07,SKU001456,632,198,434,112,1120,2025-07-22
FC_FL07,SKU001081,1597,473,1124,210,2100,2025-07-24
FC_FL07,SKU000299,591,164,427,112,1120,2025-07-22
FC_FL07,SKU001408,1609,513,1096,210,2100,2025-07-24
FC_FL07,SKU000188,532,142,390,84,840,2025-07-22
FC_FL07,SKU000452,834,245,589,140,1400,2025-07-26
FC_FL07,SKU000766,259,81,178,56,560,2025-07-24
FC_FL07,SKU001491,257,73,184,56,560,2025-07-25
FC_FL07,SKU001612,583,169,414,84,840,2025-07-22
FC_FL07,SKU000837,850,265,585,140,1400,2025-07-26
FC_FL07,SKU000385,621,175,446,112,1120,2025-07-21
FC_FL07,SKU000966,615,183,432,112,1120,2025-07-25
FC_FL07,SKU000241,1608,480,1128,210,2100,2025-07-21
FC_FL07,SKU000575,803,229,574,140,1400,2025-07-24
FC_FL07,SKU001133,642,179,463,112,1120,2025-07-25
FC_FL07,SKU001894,532,168,364,84,840,2025-07-24
FC_FL07,SKU000670,549,154,395,84,840,2025-07-23
FC_FL07,SKU001043,266,83,183,56,560,2025-07-21
FC_FL07,SKU001006,619,175,444,112,1120,2025-07-21
FC_FL07,SKU000693,258,72,186,56,560,2025-07-26
FC_FL07,SKU000577,865,269,596,140,1400,2025-07-22
FC_FL07,SKU001387,839,255,584,140,1400,2025-07-24
FC_FL07,SKU000818,615,166,449,112,1120,2025-07-26
FC_FL07,SKU000850,1554,473,1081,210,2100,2025-07-25
FC_FL07,SKU001040,555,168,387,84,840,2025-07-25
FC_FL07,SKU001505,1597,463,1134,210,2100,2025-07-21
FC_FL07,SKU001804,564,158,406,84,840,2025-07-25
FC_FL07,SKU000094,1520,422,1098,210,2100,2025-07-23
FC_FL07,SKU000869,508,148,360,84,840,2025-07-21
FC_FL07,SKU000113,566,150,416,84,840,2025-07-23
FC_FL07,SKU000083,828,253,575,140,1400,2025-07-26
FC_FL07,SKU001546,267,90,177,56,560,2025-07-27
FC_FL07,SKU000752,823,256,567,140,1400,2025-07-23
FC_FL07,SKU000014,840,266,574,140,1400,2025-07-26
FC_FL07,SKU000175,592,171,421,112,1120,2025-07-24
FC_FL07,SKU001305,1550,461,1089,210,2100,2025-07-26
FC_FL07,SKU001740,534,154,380,84,840,2025-07-25
FC_FL07,SKU000774,1500,476,1024,210,2100,2025-07-25
FC_FL07,SKU000182,1578,514,1064,210,2100,2025-07-23
FC_FL07,SKU000157,506,161,345,84,840,2025-07-26
FC_FL07,SKU001872,242,83,159,56,560,2025-07-26
FC_FL07,SKU000106,272,76,196,56,560,2025-07-26
FC_FL07,SKU001676,1536,421,1115,210,2100,2025-07-23
FC_FL07,SKU000941,247,85,162,56,560,2025-07-24
FC_FL07,SKU000750,633,226,407,112,1120,2025-07-23
FC_FL07,SKU001113,863,260,603,140,1400,2025-07-24
FC_FL07,SKU001364,558,197,361,84,840,2025-07-23
FC_FL07,SKU001824,589,168,421,112,1120,2025-07-26
FC_FL07,SKU000184,567,181,386,84,840,2025-07-27
FC_FL07,SKU001819,534,169,365,84,840,2025-07-24
FC_FL07,SKU000400,1553,466,1087,210,2100,2025-07-21
FC_FL07,SKU001567,596,165,431,112,1120,2025-07-23
FC_FL07,SKU000630,1571,479,1092,210,2100,2025-07-27
FC_FL07,SKU001674,825,256,569,140,1400,2025-07-26
FC_FL07,SKU001542,895,241,654,140,1400,2025-07-26
FC_FL07,SKU001216,651,199,452,112,1120,2025-07-22
FC_FL07,SKU001911,571,165,406,84,840,2025-07-22
FC_FL07,SKU001239,535,149,386,84,840,2025-07-27
FC_FL07,SKU000770,826,245,581,140,1400,2025-07-22
FC_FL07,SKU000488,552,161,391,84,840,2025-07-26
FC_FL07,SKU000565,884,256,628,140,1400,2025-07-22
FC_FL07,SKU000611,802,237,565,140,1400,2025-07-22
FC_FL07,SKU001797,1651,455,1196,210,2100,2025-07-24
FC_FL07,SKU000040,255,76,179,56,560,2025-07-27
FC_FL07,SKU001032,866,233,633,140,1400,2025-07-26
FC_FL07,SKU001331,1563,495,1068,210,2100,2025-07-26
FC_FL07,SKU000099,783,249,534,140,1400,2025-07-27
FC_FL07,SKU000895,533,149,384,84,840,2025-07-24
FC_FL07,SKU001126,563,158,405,84,840,2025-07-27
FC_FL07,SKU001326,243,78,165,56,560,2025-07-21
FC_FL07,SKU000093,844,269,575,140,1400,2025-07-24
FC_FL07,SKU000910,252,71,181,56,560,2025-07-21
FC_FL07,SKU000652,815,223,592,140,1400,2025-07-25
FC_FL07,SKU001020,248,70,178,56,560,2025-07-27
FC_FL07,SKU001982,835,274,561,140,1400,2025-07-22
FC_FL07,SKU000497,1538,490,1048,210,2100,2025-07-23
FC_FL07,SKU001755,1590,448,1142,210,2100,2025-07-26
FC_FL07,SKU000384,249,88,161,56,560,2025-07-25
FC_FL07,SKU001865,854,265,589,140,1400,2025-07-25
FC_FL07,SKU000889,655,196,459,112,1120,2025-07-22
FC_FL07,SKU000346,259,77,182,56,560,2025-07-21
FC_FL07,SKU001315,855,263,592,140,1400,2025-07-24
FC_FL07,SKU001435,654,202,452,112,1120,2025-07-21
FC_FL07,SKU000381,889,251,638,140,1400,2025-07-27
FC_FL07,SKU001366,1551,493,1058,210,2100,2025-07-26
FC_FL07,SKU000331,1566,459,1107,210,2100,2025-07-26
FC_FL07,SKU000791,595,189,406,112,1120,2025-07-23
FC_FL07,SKU001794,604,165,439,112,1120,2025-07-22
FC_FL07,SKU001822,1567,507,1060,210,2100,2025-07-24
FC_FL07,SKU000838,819,239,580,140,1400,2025-07-27
FC_FL07,SKU000103,812,227,585,140,1400,2025-07-25
FC_FL07,SKU000440,857,246,611,140,1400,2025-07-27
FC_FL07,SKU000208,262,75,187,56,560,2025-07-24
FC_FL07,SKU000073,608,160,448,112,1120,2025-07-27
FC_FL07,SKU000306,802,243,559,140,1400,2025-07-21
FC_FL07,SKU000543,785,247,538,140,1400,2025-07-21
FC_FL07,SKU000484,824,259,565,140,1400,2025-07-25
FC_FL07,SKU000795,849,251,598,140,1400,2025-07-22
FC_FL07,SKU001825,543,174,369,84,840,2025-07-24
FC_FL07,SKU001376,628,156,472,112,1120,2025-07-26
FC_FL07,SKU000221,1599,482,1117,210,2100,2025-07-21
FC_FL07,SKU001561,1585,493,1092,210,2100,2025-07-25
FC_FL07,SKU001419,251,73,178,56,560,2025-07-25
FC_FL07,SKU000973,254,76,178,56,560,2025-07-25
FC_FL07,SKU000268,235,65,170,56,560,2025-07-23
FC_FL07,SKU000054,1552,481,1071,210,2100,2025-07-27
FC_FL07,SKU000360,266,81,185,56,560,2025-07-26
FC_FL07,SKU001035,831,274,557,140,1400,2025-07-24
FC_FL07,SKU000701,1613,484,1129,210,2100,2025-07-21
FC_FL07,SKU001685,1598,476,1122,210,2100,2025-07-23
FC_FL07,SKU001923,540,158,382,84,840,2025-07-21
FC_FL07,SKU000970,1578,459,1119,210,2100,2025-07-25
FC_FL07,SKU000836,829,257,572,140,1400,2025-07-24
FC_FL07,SKU001885,610,162,448,112,1120,2025-07-22
FC_FL07,SKU001700,589,176,413,84,840,2025-07-25
FC_FL07,SKU000297,612,168,444,112,1120,2025-07-22
FC_FL07,SKU001111,888,287,601,140,1400,2025-07-27
FC_FL07,SKU000607,545,163,382,84,840,2025-07-21
FC_FL07,SKU000735,793,241,552,140,1400,2025-07-26
FC_FL07,SKU001307,866,270,596,140,1400,2025-07-27
FC_FL07,SKU001310,248,78,170,56,560,2025-07-26
FC_FL07,SKU001228,530,163,367,84,840,2025-07-24
FC_FL07,SKU001300,590,193,397,112,1120,2025-07-26
FC_FL07,SKU000702,271,73,198,56,560,2025-07-26
FC_FL07,SKU001010,259,78,181,56,560,2025-07-21
FC_FL07,SKU000691,561,165,396,84,840,2025-07-22
FC_FL07,SKU001313,1643,481,1162,210,2100,2025-07-26
FC_FL07,SKU000674,264,77,187,56,560,2025-07-25
FC_FL07,SKU000252,587,164,423,112,1120,2025-07-22
FC_FL07,SKU001401,571,158,413,84,840,2025-07-21
FC_FL07,SKU001123,262,75,187,56,560,2025-07-22
FC_FL07,SKU000304,844,228,616,140,1400,2025-07-23
FC_FL07,SKU000165,245,73,172,56,560,2025-07-23
FC_FL07,SKU000890,839,240,599,140,1400,2025-07-25
FC_FL07,SKU000266,576,192,384,84,840,2025-07-22
FC_FL07,SKU000026,608,192,416,112,1120,2025-07-26
FC_FL07,SKU001030,626,192,434,112,1120,2025-07-21
FC_FL07,SKU001083,1496,459,1037,210,2100,2025-07-25
FC_FL07,SKU001756,238,56,182,56,560,2025-07-25
FC_FL07,SKU000692,632,177,455,112,1120,2025-07-23
FC_FL07,SKU001367,578,180,398,84,840,2025-07-27
FC_FL07,SKU001844,594,178,416,112,1120,2025-07-21
FC_FL07,SKU000602,266,69,197,56,560,2025-07-23
FC_FL07,SKU001391,554,169,385,84,840,2025-07-26
FC_FL07,SKU000072,616,204,412,112,1120,2025-07-27
FC_FL07,SKU001317,1685,499,1186,210,2100,2025-07-25
FC_FL07,SKU001302,633,202,431,112,1120,2025-07-25
FC_FL07,SKU001730,253,80,173,56,560,2025-07-22
FC_FL07,SKU001411,1526,448,1078,210,2100,2025-07-23
FC_FL07,SKU000931,557,184,373,112,1120,2025-07-24
FC_FL07,SKU000887,227,81,146,56,560,2025-07-24
FC_FL07,SKU001939,542,143,399,84,840,2025-07-23
FC_FL07,SKU000423,1558,446,1112,210,2100,2025-07-25
FC_FL07,SKU001187,255,77,178,56,560,2025-07-21
FC_FL07,SKU001743,842,250,592,140,1400,2025-07-22
FC_FL07,SKU000104,613,186,427,112,1120,2025-07-21
FC_FL07,SKU001468,644,210,434,112,1120,2025-07-24
FC_FL07,SKU000057,558,184,374,84,840,2025-07-25
FC_FL07,SKU001429,790,252,538,140,1400,2025-07-27
FC_FL07,SKU000159,797,260,537,140,1400,2025-07-27
FC_FL07,SKU001061,560,175,385,84,840,2025-07-26
FC_FL07,SKU001717,238,75,163,56,560,2025-07-23
FC_FL07,SKU000231,778,226,552,140,1400,2025-07-27
FC_FL07,SKU001508,800,224,576,140,1400,2025-07-25
FC_FL07,SKU001912,813,243,570,140,1400,2025-07-25
FC_FL07,SKU001306,590,197,393,112,1120,2025-07-22
FC_FL07,SKU000233,597,213,384,112,1120,2025-07-24
FC_FL07,SKU000485,538,152,386,84,840,2025-07-21
FC_FL07,SKU001293,252,77,175,56,560,2025-07-25
FC_FL07,SKU001878,258,67,191,56,560,2025-07-21
FC_FL07,SKU000124,235,69,166,56,560,2025-07-21
FC_FL07,SKU001628,641,204,437,112,1120,2025-07-24
FC_FL07,SKU000342,584,140,444,112,1120,2025-07-24
FC_FL07,SKU000953,530,145,385,84,840,2025-07-22
FC_FL07,SKU001784,607,175,432,112,1120,2025-07-21
FC_FL07,SKU001286,552,162,390,84,840,2025-07-25
FC_FL07,SKU001996,557,173,384,84,840,2025-07-25
FC_FL07,SKU001516,866,251,615,140,1400,2025-07-25
FC_FL07,SKU000852,245,71,174,56,560,2025-07-21
FC_FL07,SKU001592,561,178,383,112,1120,2025-07-25
FC_FL07,SKU000082,621,175,446,112,1120,2025-07-27
FC_FL07,SKU001810,669,192,477,112,1120,2025-07-27
FC_FL07,SKU001957,1535,471,1064,210,2100,2025-07-21
FC_FL07,SKU000246,846,244,602,140,1400,2025-07-24
FC_FL07,SKU001861,1573,478,1095,210,2100,2025-07-27
FC_FL07,SKU001478,893,260,633,140,1400,2025-07-22
FC_FL07,SKU001425,623,186,437,112,1120,2025-07-24
FC_FL07,SKU000542,671,199,472,112,1120,2025-07-23
FC_FL07,SKU000229,247,75,172,56,560,2025-07-27
FC_FL07,SKU001600,836,251,585,140,1400,2025-07-22
FC_FL07,SKU001914,820,243,577,140,1400,2025-07-25
FC_FL07,SKU001337,636,190,446,112,1120,2025-07-27
FC_FL07,SKU000828,599,212,387,112,1120,2025-07-27
FC_FL07,SKU001946,816,253,563,140,1400,2025-07-23
FC_FL07,SKU000437,1526,484,1042,210,2100,2025-07-22
FC_FL07,SKU001234,592,160,432,112,1120,2025-07-22
FC_FL07,SKU000723,617,193,424,112,1120,2025-07-25
FC_FL07,SKU001199,260,87,173,56,560,2025-07-26
FC_FL07,SKU001285,230,67,163,56,560,2025-07-21
FC_FL07,SKU001927,549,178,371,84,840,2025-07-23
FC_FL07,SKU000687,538,171,367,84,840,2025-07-22
FC_FL07,SKU000486,1579,449,1130,210,2100,2025-07-22
FC_FL07,SKU001840,520,158,362,84,840,2025-07-25
FC_FL07,SKU001513,1628,489,1139,210,2100,2025-07-27
FC_FL07,SKU000095,591,188,403,84,840,2025-07-25
FC_FL07,SKU000576,606,218,388,112,1120,2025-07-25
FC_FL07,SKU000398,247,72,175,56,560,2025-07-21
FC_FL07,SKU001204,252,52,200,56,560,2025-07-22
FC_FL07,SKU000685,565,179,386,84,840,2025-07-27
FC_FL07,SKU001186,554,178,376,84,840,2025-07-23
FC_FL07,SKU000526,249,63,186,56,560,2025-07-27
FC_FL07,SKU001021,573,168,405,84,840,2025-07-22
FC_FL07,SKU000534,550,152,398,84,840,2025-07-24
FC_FL07,SKU000997,254,59,195,56,560,2025-07-27
FC_FL07,SKU001718,560,155,405,84,840,2025-07-25
FC_FL07,SKU001163,606,192,414,112,1120,2025-07-25
FC_FL07,SKU000664,816,245,571,140,1400,2025-07-26
FC_FL07,SKU001677,214,74,140,56,560,2025-07-22
FC_FL07,SKU001972,259,79,180,56,560,2025-07-26
FC_FL07,SKU000533,257,77,180,56,560,2025-07-27
FC_FL07,SKU000668,816,248,568,140,1400,2025-07-22
FC_FL07,SKU000870,1537,488,1049,210,2100,2025-07-25
FC_FL07,SKU000965,1553,471,1082,210,2100,2025-07-24
FC_FL07,SKU001760,1531,425,1106,210,2100,2025-07-27
FC_FL07,SKU000362,653,186,467,112,1120,2025-07-23
FC_FL07,SKU000756,558,169,389,84,840,2025-07-25
FC_FL07,SKU001498,627,213,414,112,1120,2025-07-22
FC_FL07,SKU000012,807,248,559,140,1400,2025-07-21
FC_FL07,SKU000635,585,196,389,84,840,2025-07-24
FC_FL07,SKU000310,893,292,601,140,1400,2025-07-23
FC_FL07,SKU000209,546,165,381,84,840,2025-07-27
FC_FL07,SKU001941,618,145,473,112,1120,2025-07-23
FC_FL07,SKU001688,610,174,436,112,1120,2025-07-23
FC_FL07,SKU000516,633,201,432,112,1120,2025-07-25
FC_FL07,SKU001739,579,189,390,112,1120,2025-07-25
FC_FL07,SKU001932,816,263,553,140,1400,2025-07-24
FC_FL07,SKU002000,572,173,399,84,840,2025-07-24
FC_FL07,SKU001525,1640,443,1197,210,2100,2025-07-23
FC_FL07,SKU000419,633,194,439,112,1120,2025-07-24
FC_FL07,SKU000725,619,168,451,112,1120,2025-07-26
FC_FL07,SKU000563,871,256,615,140,1400,2025-07-24
FC_FL07,SKU000377,541,163,378,84,840,2025-07-23
FC_FL07,SKU001710,615,182,433,112,1120,2025-07-21
FC_FL07,SKU000936,1545,479,1066,210,2100,2025-07-23
FC_FL07,SKU000962,555,167,388,84,840,2025-07-24
FC_FL07,SKU001402,541,162,379,84,840,2025-07-22
FC_FL07,SKU001920,879,230,649,140,1400,2025-07-26
FC_FL07,SKU001991,652,192,460,112,1120,2025-07-26
FC_FL07,SKU001272,550,171,379,84,840,2025-07-27
FC_FL07,SKU000286,887,273,614,140,1400,2025-07-24
FC_FL07,SKU000944,230,61,169,56,560,2025-07-25
FC_FL07,SKU000036,881,268,613,140,1400,2025-07-25
FC_FL07,SKU000520,545,166,379,84,840,2025-07-26
FC_FL07,SKU000282,603,165,438,112,1120,2025-07-21
FC_FL07,SKU001703,614,204,410,112,1120,2025-07-22
FC_FL07,SKU000786,645,184,461,112,1120,2025-07-24
FC_FL07,SKU001264,252,66,186,56,560,2025-07-25
FC_FL07,SKU001170,828,297,531,140,1400,2025-07-25
FC_FL07,SKU001551,914,302,612,140,1400,2025-07-27
FC_FL07,SKU001086,633,208,425,112,1120,2025-07-21
FC_FL07,SKU000130,243,66,177,56,560,2025-07-25
FC_FL07,SKU001385,641,210,431,112,1120,2025-07-21
FC_FL07,SKU000481,1615,474,1141,210,2100,2025-07-25
FC_FL07,SKU001277,838,261,577,140,1400,2025-07-24
FC_FL07,SKU001966,621,200,421,112,1120,2025-07-21
FC_FL07,SKU000461,600,191,409,112,1120,2025-07-25
FC_FL07,SKU000508,541,180,361,84,840,2025-07-26
FC_FL07,SKU001049,571,176,395,84,840,2025-07-27
FC_FL07,SKU000529,584,174,410,84,840,2025-07-26
FC_FL07,SKU000553,801,263,538,140,1400,2025-07-26
FC_FL07,SKU001616,258,79,179,56,560,2025-07-26
FC_FL07,SKU000163,1627,484,1143,210,2100,2025-07-21
FC_FL07,SKU000295,823,267,556,140,1400,2025-07-21
FC_FL07,SKU000459,818,265,553,140,1400,2025-07-26
FC_FL07,SKU000438,511,127,384,84,840,2025-07-27
FC_FL07,SKU000359,834,298,536,140,1400,2025-07-22
FC_FL07,SKU001064,1520,478,1042,210,2100,2025-07-25
FC_FL07,SKU000517,872,267,605,140,1400,2025-07-22
FC_FL07,SKU000921,526,150,376,84,840,2025-07-24
FC_FL07,SKU000328,839,241,598,140,1400,2025-07-26
FC_FL07,SKU001609,1584,499,1085,210,2100,2025-07-23
FC_FL07,SKU000654,247,80,167,56,560,2025-07-21
FC_FL07,SKU000066,261,83,178,56,560,2025-07-26
FC_FL07,SKU001640,569,188,381,112,1120,2025-07-24
FC_FL07,SKU001820,623,206,417,112,1120,2025-07-27
FC_FL07,SKU001477,599,164,435,112,1120,2025-07-21
FC_FL07,SKU000293,651,186,465,112,1120,2025-07-22
FC_FL07,SKU000422,256,67,189,56,560,2025-07-26
FC_FL07,SKU001712,609,185,424,112,1120,2025-07-27
FC_FL07,SKU000875,253,73,180,56,560,2025-07-22
FC_FL07,SKU001917,1551,444,1107,210,2100,2025-07-27
FC_FL07,SKU000307,845,252,593,140,1400,2025-07-23
FC_FL07,SKU001512,293,89,204,56,560,2025-07-21
